filename,width,height,class,label,interval,left,right,source
0000.jpg,432,288,N,1,293,77,370,MIT_BIH_ECG
0001.jpg,432,288,N,1,292,370,662,MIT_BIH_ECG
0002.jpg,432,288,N,1,284,662,946,MIT_BIH_ECG
0003.jpg,432,288,N,1,285,946,1231,MIT_BIH_ECG
0004.jpg,432,288,N,1,284,1231,1515,MIT_BIH_ECG
0005.jpg,432,288,N,1,294,1515,1809,MIT_BIH_ECG
0006.jpg,432,288,N,1,235,1809,2044,MIT_BIH_ECG
0007.jpg,432,288,A_A,0,358,2044,2402,MIT_BIH_ECG
0008.jpg,432,288,N,1,304,2402,2706,MIT_BIH_ECG
0009.jpg,432,288,N,1,292,2706,2998,MIT_BIH_ECG
0010.jpg,432,288,N,1,284,2998,3282,MIT_BIH_ECG
0011.jpg,432,288,N,1,278,3282,3560,MIT_BIH_ECG
0012.jpg,432,288,N,1,302,3560,3862,MIT_BIH_ECG
0013.jpg,432,288,N,1,308,3862,4170,MIT_BIH_ECG
0014.jpg,432,288,N,1,296,4170,4466,MIT_BIH_ECG
0015.jpg,432,288,N,1,298,4466,4764,MIT_BIH_ECG
0016.jpg,432,288,N,1,296,4764,5060,MIT_BIH_ECG
0017.jpg,432,288,N,1,286,5060,5346,MIT_BIH_ECG
0018.jpg,432,288,N,1,287,5346,5633,MIT_BIH_ECG
0019.jpg,432,288,N,1,285,5633,5918,MIT_BIH_ECG
0020.jpg,432,288,N,1,296,5918,6214,MIT_BIH_ECG
0021.jpg,432,288,N,1,313,6214,6527,MIT_BIH_ECG
0022.jpg,432,288,N,1,296,6527,6823,MIT_BIH_ECG
0023.jpg,432,288,N,1,283,6823,7106,MIT_BIH_ECG
0024.jpg,432,288,N,1,285,7106,7391,MIT_BIH_ECG
0025.jpg,432,288,N,1,279,7391,7670,MIT_BIH_ECG
0026.jpg,432,288,N,1,283,7670,7953,MIT_BIH_ECG
0027.jpg,432,288,N,1,292,7953,8245,MIT_BIH_ECG
0028.jpg,432,288,N,1,294,8245,8539,MIT_BIH_ECG
0029.jpg,432,288,N,1,298,8539,8837,MIT_BIH_ECG
0030.jpg,432,288,N,1,304,8837,9141,MIT_BIH_ECG
0031.jpg,432,288,N,1,290,9141,9431,MIT_BIH_ECG
0032.jpg,432,288,N,1,279,9431,9710,MIT_BIH_ECG
0033.jpg,432,288,N,1,288,9710,9998,MIT_BIH_ECG
0034.jpg,432,288,N,1,284,9998,10282,MIT_BIH_ECG
0035.jpg,432,288,N,1,309,10282,10591,MIT_BIH_ECG
0036.jpg,432,288,N,1,303,10591,10894,MIT_BIH_ECG
0037.jpg,432,288,N,1,297,10894,11191,MIT_BIH_ECG
0038.jpg,432,288,N,1,289,11191,11480,MIT_BIH_ECG
0039.jpg,432,288,N,1,301,11480,11781,MIT_BIH_ECG
0040.jpg,432,288,N,1,285,11781,12066,MIT_BIH_ECG
0041.jpg,432,288,N,1,284,12066,12350,MIT_BIH_ECG
0042.jpg,432,288,N,1,295,12350,12645,MIT_BIH_ECG
0043.jpg,432,288,N,1,304,12645,12949,MIT_BIH_ECG
0044.jpg,432,288,N,1,317,12949,13266,MIT_BIH_ECG
0045.jpg,432,288,N,1,296,13266,13562,MIT_BIH_ECG
0046.jpg,432,288,N,1,280,13562,13842,MIT_BIH_ECG
0047.jpg,432,288,N,1,289,13842,14131,MIT_BIH_ECG
0048.jpg,432,288,N,1,292,14131,14423,MIT_BIH_ECG
0049.jpg,432,288,N,1,287,14423,14710,MIT_BIH_ECG
0050.jpg,432,288,N,1,301,14710,15011,MIT_BIH_ECG
0051.jpg,432,288,N,1,299,15011,15310,MIT_BIH_ECG
0052.jpg,432,288,N,1,297,15310,15607,MIT_BIH_ECG
0053.jpg,432,288,N,1,292,15607,15899,MIT_BIH_ECG
0054.jpg,432,288,N,1,284,15899,16183,MIT_BIH_ECG
0055.jpg,432,288,N,1,281,16183,16464,MIT_BIH_ECG
0056.jpg,432,288,N,1,291,16464,16755,MIT_BIH_ECG
0057.jpg,432,288,N,1,303,16755,17058,MIT_BIH_ECG
0058.jpg,432,288,N,1,300,17058,17358,MIT_BIH_ECG
0059.jpg,432,288,N,1,299,17358,17657,MIT_BIH_ECG
0060.jpg,432,288,N,1,290,17657,17947,MIT_BIH_ECG
0061.jpg,432,288,N,1,280,17947,18227,MIT_BIH_ECG
0062.jpg,432,288,N,1,287,18227,18514,MIT_BIH_ECG
0063.jpg,432,288,N,1,281,18514,18795,MIT_BIH_ECG
0064.jpg,432,288,N,1,285,18795,19080,MIT_BIH_ECG
0065.jpg,432,288,N,1,308,19080,19388,MIT_BIH_ECG
0066.jpg,432,288,N,1,305,19388,19693,MIT_BIH_ECG
0067.jpg,432,288,N,1,296,19693,19989,MIT_BIH_ECG
0068.jpg,432,288,N,1,282,19989,20271,MIT_BIH_ECG
0069.jpg,432,288,N,1,283,20271,20554,MIT_BIH_ECG
0070.jpg,432,288,N,1,283,20554,20837,MIT_BIH_ECG
0071.jpg,432,288,N,1,294,20837,21131,MIT_BIH_ECG
0072.jpg,432,288,N,1,292,21131,21423,MIT_BIH_ECG
0073.jpg,432,288,N,1,306,21423,21729,MIT_BIH_ECG
0074.jpg,432,288,N,1,300,21729,22029,MIT_BIH_ECG
0075.jpg,432,288,N,1,292,22029,22321,MIT_BIH_ECG
0076.jpg,432,288,N,1,282,22321,22603,MIT_BIH_ECG
0077.jpg,432,288,N,1,278,22603,22881,MIT_BIH_ECG
0078.jpg,432,288,N,1,283,22881,23164,MIT_BIH_ECG
0079.jpg,432,288,N,1,289,23164,23453,MIT_BIH_ECG
0080.jpg,432,288,N,1,303,23453,23756,MIT_BIH_ECG
0081.jpg,432,288,N,1,297,23756,24053,MIT_BIH_ECG
0082.jpg,432,288,N,1,292,24053,24345,MIT_BIH_ECG
0083.jpg,432,288,N,1,280,24345,24625,MIT_BIH_ECG
0084.jpg,432,288,N,1,288,24625,24913,MIT_BIH_ECG
0085.jpg,432,288,N,1,284,24913,25197,MIT_BIH_ECG
0086.jpg,432,288,N,1,288,25197,25485,MIT_BIH_ECG
0087.jpg,432,288,N,1,294,25485,25779,MIT_BIH_ECG
0088.jpg,432,288,N,1,309,25779,26088,MIT_BIH_ECG
0089.jpg,432,288,N,1,299,26088,26387,MIT_BIH_ECG
0090.jpg,432,288,N,1,283,26387,26670,MIT_BIH_ECG
0091.jpg,432,288,N,1,282,26670,26952,MIT_BIH_ECG
0092.jpg,432,288,N,1,285,26952,27237,MIT_BIH_ECG
0093.jpg,432,288,N,1,299,27237,27536,MIT_BIH_ECG
0094.jpg,432,288,N,1,297,27536,27833,MIT_BIH_ECG
0095.jpg,432,288,N,1,299,27833,28132,MIT_BIH_ECG
0096.jpg,432,288,N,1,299,28132,28431,MIT_BIH_ECG
0097.jpg,432,288,N,1,296,28431,28727,MIT_BIH_ECG
0098.jpg,432,288,N,1,287,28727,29014,MIT_BIH_ECG
0099.jpg,432,288,N,1,280,29014,29294,MIT_BIH_ECG
0100.jpg,432,288,N,1,286,29294,29580,MIT_BIH_ECG
0101.jpg,432,288,N,1,293,29580,29873,MIT_BIH_ECG
0102.jpg,432,288,N,1,309,29873,30182,MIT_BIH_ECG
0103.jpg,432,288,N,1,305,30182,30487,MIT_BIH_ECG
0104.jpg,432,288,N,1,292,30487,30779,MIT_BIH_ECG
0105.jpg,432,288,N,1,286,30779,31065,MIT_BIH_ECG
0106.jpg,432,288,N,1,283,31065,31348,MIT_BIH_ECG
0107.jpg,432,288,N,1,287,31348,31635,MIT_BIH_ECG
0108.jpg,432,288,N,1,292,31635,31927,MIT_BIH_ECG
0109.jpg,432,288,N,1,297,31927,32224,MIT_BIH_ECG
0110.jpg,432,288,N,1,305,32224,32529,MIT_BIH_ECG
0111.jpg,432,288,N,1,307,32529,32836,MIT_BIH_ECG
0112.jpg,432,288,N,1,291,32836,33127,MIT_BIH_ECG
0113.jpg,432,288,N,1,276,33127,33403,MIT_BIH_ECG
0114.jpg,432,288,N,1,288,33403,33691,MIT_BIH_ECG
0115.jpg,432,288,N,1,289,33691,33980,MIT_BIH_ECG
0116.jpg,432,288,N,1,294,33980,34274,MIT_BIH_ECG
0117.jpg,432,288,N,1,301,34274,34575,MIT_BIH_ECG
0118.jpg,432,288,N,1,295,34575,34870,MIT_BIH_ECG
0119.jpg,432,288,N,1,298,34870,35168,MIT_BIH_ECG
0120.jpg,432,288,N,1,287,35168,35455,MIT_BIH_ECG
0121.jpg,432,288,N,1,281,35455,35736,MIT_BIH_ECG
0122.jpg,432,288,N,1,280,35736,36016,MIT_BIH_ECG
0123.jpg,432,288,N,1,293,36016,36309,MIT_BIH_ECG
0124.jpg,432,288,N,1,296,36309,36605,MIT_BIH_ECG
0125.jpg,432,288,N,1,311,36605,36916,MIT_BIH_ECG
0126.jpg,432,288,N,1,299,36916,37215,MIT_BIH_ECG
0127.jpg,432,288,N,1,284,37215,37499,MIT_BIH_ECG
0128.jpg,432,288,N,1,283,37499,37782,MIT_BIH_ECG
0129.jpg,432,288,N,1,289,37782,38071,MIT_BIH_ECG
0130.jpg,432,288,N,1,285,38071,38356,MIT_BIH_ECG
0131.jpg,432,288,N,1,295,38356,38651,MIT_BIH_ECG
0132.jpg,432,288,N,1,299,38651,38950,MIT_BIH_ECG
0133.jpg,432,288,N,1,302,38950,39252,MIT_BIH_ECG
0134.jpg,432,288,N,1,295,39252,39547,MIT_BIH_ECG
0135.jpg,432,288,N,1,278,39547,39825,MIT_BIH_ECG
0136.jpg,432,288,N,1,271,39825,40096,MIT_BIH_ECG
0137.jpg,432,288,N,1,286,40096,40382,MIT_BIH_ECG
0138.jpg,432,288,N,1,295,40382,40677,MIT_BIH_ECG
0139.jpg,432,288,N,1,293,40677,40970,MIT_BIH_ECG
0140.jpg,432,288,N,1,301,40970,41271,MIT_BIH_ECG
0141.jpg,432,288,N,1,296,41271,41567,MIT_BIH_ECG
0142.jpg,432,288,N,1,282,41567,41849,MIT_BIH_ECG
0143.jpg,432,288,N,1,268,41849,42117,MIT_BIH_ECG
0144.jpg,432,288,N,1,299,42117,42416,MIT_BIH_ECG
0145.jpg,432,288,N,1,281,42416,42697,MIT_BIH_ECG
0146.jpg,432,288,N,1,299,42697,42996,MIT_BIH_ECG
0147.jpg,432,288,N,1,311,42996,43307,MIT_BIH_ECG
0148.jpg,432,288,N,1,296,43307,43603,MIT_BIH_ECG
0149.jpg,432,288,N,1,289,43603,43892,MIT_BIH_ECG
0150.jpg,432,288,N,1,280,43892,44172,MIT_BIH_ECG
0151.jpg,432,288,N,1,283,44172,44455,MIT_BIH_ECG
0152.jpg,432,288,N,1,288,44455,44743,MIT_BIH_ECG
0153.jpg,432,288,N,1,287,44743,45030,MIT_BIH_ECG
0154.jpg,432,288,N,1,293,45030,45323,MIT_BIH_ECG
0155.jpg,432,288,N,1,305,45323,45628,MIT_BIH_ECG
0156.jpg,432,288,N,1,297,45628,45925,MIT_BIH_ECG
0157.jpg,432,288,N,1,279,45925,46204,MIT_BIH_ECG
0158.jpg,432,288,N,1,274,46204,46478,MIT_BIH_ECG
0159.jpg,432,288,N,1,281,46478,46759,MIT_BIH_ECG
0160.jpg,432,288,N,1,278,46759,47037,MIT_BIH_ECG
0161.jpg,432,288,N,1,297,47037,47334,MIT_BIH_ECG
0162.jpg,432,288,N,1,298,47334,47632,MIT_BIH_ECG
0163.jpg,432,288,N,1,287,47632,47919,MIT_BIH_ECG
0164.jpg,432,288,N,1,283,47919,48202,MIT_BIH_ECG
0165.jpg,432,288,N,1,284,48202,48486,MIT_BIH_ECG
0166.jpg,432,288,N,1,280,48486,48766,MIT_BIH_ECG
0167.jpg,432,288,N,1,274,48766,49040,MIT_BIH_ECG
0168.jpg,432,288,N,1,283,49040,49323,MIT_BIH_ECG
0169.jpg,432,288,N,1,295,49323,49618,MIT_BIH_ECG
0170.jpg,432,288,N,1,305,49618,49923,MIT_BIH_ECG
0171.jpg,432,288,N,1,291,49923,50214,MIT_BIH_ECG
0172.jpg,432,288,N,1,277,50214,50491,MIT_BIH_ECG
0173.jpg,432,288,N,1,280,50491,50771,MIT_BIH_ECG
0174.jpg,432,288,N,1,285,50771,51056,MIT_BIH_ECG
0175.jpg,432,288,N,1,283,51056,51339,MIT_BIH_ECG
0176.jpg,432,288,N,1,287,51339,51626,MIT_BIH_ECG
0177.jpg,432,288,N,1,295,51626,51921,MIT_BIH_ECG
0178.jpg,432,288,N,1,295,51921,52216,MIT_BIH_ECG
0179.jpg,432,288,N,1,290,52216,52506,MIT_BIH_ECG
0180.jpg,432,288,N,1,278,52506,52784,MIT_BIH_ECG
0181.jpg,432,288,N,1,279,52784,53063,MIT_BIH_ECG
0182.jpg,432,288,N,1,278,53063,53341,MIT_BIH_ECG
0183.jpg,432,288,N,1,290,53341,53631,MIT_BIH_ECG
0184.jpg,432,288,N,1,292,53631,53923,MIT_BIH_ECG
0185.jpg,432,288,N,1,296,53923,54219,MIT_BIH_ECG
0186.jpg,432,288,N,1,288,54219,54507,MIT_BIH_ECG
0187.jpg,432,288,N,1,277,54507,54784,MIT_BIH_ECG
0188.jpg,432,288,N,1,280,54784,55064,MIT_BIH_ECG
0189.jpg,432,288,N,1,279,55064,55343,MIT_BIH_ECG
0190.jpg,432,288,N,1,282,55343,55625,MIT_BIH_ECG
0191.jpg,432,288,N,1,283,55625,55908,MIT_BIH_ECG
0192.jpg,432,288,N,1,299,55908,56207,MIT_BIH_ECG
0193.jpg,432,288,N,1,295,56207,56502,MIT_BIH_ECG
0194.jpg,432,288,N,1,282,56502,56784,MIT_BIH_ECG
0195.jpg,432,288,N,1,271,56784,57055,MIT_BIH_ECG
0196.jpg,432,288,N,1,278,57055,57333,MIT_BIH_ECG
0197.jpg,432,288,N,1,282,57333,57615,MIT_BIH_ECG
0198.jpg,432,288,N,1,285,57615,57900,MIT_BIH_ECG
0199.jpg,432,288,N,1,292,57900,58192,MIT_BIH_ECG
0200.jpg,432,288,N,1,298,58192,58490,MIT_BIH_ECG
0201.jpg,432,288,N,1,298,58490,58788,MIT_BIH_ECG
0202.jpg,432,288,N,1,289,58788,59077,MIT_BIH_ECG
0203.jpg,432,288,N,1,277,59077,59354,MIT_BIH_ECG
0204.jpg,432,288,N,1,277,59354,59631,MIT_BIH_ECG
0205.jpg,432,288,N,1,288,59631,59919,MIT_BIH_ECG
0206.jpg,432,288,N,1,295,59919,60214,MIT_BIH_ECG
0207.jpg,432,288,N,1,301,60214,60515,MIT_BIH_ECG
0208.jpg,432,288,N,1,302,60515,60817,MIT_BIH_ECG
0209.jpg,432,288,N,1,288,60817,61105,MIT_BIH_ECG
0210.jpg,432,288,N,1,286,61105,61391,MIT_BIH_ECG
0211.jpg,432,288,N,1,289,61391,61680,MIT_BIH_ECG
0212.jpg,432,288,N,1,283,61680,61963,MIT_BIH_ECG
0213.jpg,432,288,N,1,284,61963,62247,MIT_BIH_ECG
0214.jpg,432,288,N,1,300,62247,62547,MIT_BIH_ECG
0215.jpg,432,288,N,1,305,62547,62852,MIT_BIH_ECG
0216.jpg,432,288,N,1,302,62852,63154,MIT_BIH_ECG
0217.jpg,432,288,N,1,284,63154,63438,MIT_BIH_ECG
0218.jpg,432,288,N,1,273,63438,63711,MIT_BIH_ECG
0219.jpg,432,288,N,1,287,63711,63998,MIT_BIH_ECG
0220.jpg,432,288,N,1,290,63998,64288,MIT_BIH_ECG
0221.jpg,432,288,N,1,293,64288,64581,MIT_BIH_ECG
0222.jpg,432,288,N,1,295,64581,64876,MIT_BIH_ECG
0223.jpg,432,288,N,1,298,64876,65174,MIT_BIH_ECG
0224.jpg,432,288,N,1,290,65174,65464,MIT_BIH_ECG
0225.jpg,432,288,N,1,286,65464,65750,MIT_BIH_ECG
0226.jpg,432,288,N,1,280,65750,66030,MIT_BIH_ECG
0227.jpg,432,288,N,1,277,66030,66307,MIT_BIH_ECG
0228.jpg,432,288,N,1,297,66307,66604,MIT_BIH_ECG
0229.jpg,432,288,N,1,188,66604,66792,MIT_BIH_ECG
0230.jpg,432,288,A_A,0,338,66792,67130,MIT_BIH_ECG
0231.jpg,432,288,N,1,304,67130,67434,MIT_BIH_ECG
0232.jpg,432,288,N,1,294,67434,67728,MIT_BIH_ECG
0233.jpg,432,288,N,1,279,67728,68007,MIT_BIH_ECG
0234.jpg,432,288,N,1,295,68007,68302,MIT_BIH_ECG
0235.jpg,432,288,N,1,292,68302,68594,MIT_BIH_ECG
0236.jpg,432,288,N,1,292,68594,68886,MIT_BIH_ECG
0237.jpg,432,288,N,1,305,68886,69191,MIT_BIH_ECG
0238.jpg,432,288,N,1,312,69191,69503,MIT_BIH_ECG
0239.jpg,432,288,N,1,293,69503,69796,MIT_BIH_ECG
0240.jpg,432,288,N,1,277,69796,70073,MIT_BIH_ECG
0241.jpg,432,288,N,1,284,70073,70357,MIT_BIH_ECG
0242.jpg,432,288,N,1,286,70357,70643,MIT_BIH_ECG
0243.jpg,432,288,N,1,298,70643,70941,MIT_BIH_ECG
0244.jpg,432,288,N,1,299,70941,71240,MIT_BIH_ECG
0245.jpg,432,288,N,1,299,71240,71539,MIT_BIH_ECG
0246.jpg,432,288,N,1,306,71539,71845,MIT_BIH_ECG
0247.jpg,432,288,N,1,293,71845,72138,MIT_BIH_ECG
0248.jpg,432,288,N,1,279,72138,72417,MIT_BIH_ECG
0249.jpg,432,288,N,1,286,72417,72703,MIT_BIH_ECG
0250.jpg,432,288,N,1,295,72703,72998,MIT_BIH_ECG
0251.jpg,432,288,N,1,303,72998,73301,MIT_BIH_ECG
0252.jpg,432,288,N,1,310,73301,73611,MIT_BIH_ECG
0253.jpg,432,288,N,1,300,73611,73911,MIT_BIH_ECG
0254.jpg,432,288,N,1,285,73911,74196,MIT_BIH_ECG
0255.jpg,432,288,N,1,287,74196,74483,MIT_BIH_ECG
0256.jpg,432,288,N,1,284,74483,74767,MIT_BIH_ECG
0257.jpg,432,288,N,1,219,74767,74986,MIT_BIH_ECG
0258.jpg,432,288,A_A,0,346,74986,75332,MIT_BIH_ECG
0259.jpg,432,288,N,1,300,75332,75632,MIT_BIH_ECG
0260.jpg,432,288,N,1,302,75632,75934,MIT_BIH_ECG
0261.jpg,432,288,N,1,299,75934,76233,MIT_BIH_ECG
0262.jpg,432,288,N,1,282,76233,76515,MIT_BIH_ECG
0263.jpg,432,288,N,1,270,76515,76785,MIT_BIH_ECG
0264.jpg,432,288,N,1,289,76785,77074,MIT_BIH_ECG
0265.jpg,432,288,N,1,292,77074,77366,MIT_BIH_ECG
0266.jpg,432,288,N,1,297,77366,77663,MIT_BIH_ECG
0267.jpg,432,288,N,1,291,77663,77954,MIT_BIH_ECG
0268.jpg,432,288,N,1,297,77954,78251,MIT_BIH_ECG
0269.jpg,432,288,N,1,288,78251,78539,MIT_BIH_ECG
0270.jpg,432,288,N,1,285,78539,78824,MIT_BIH_ECG
0271.jpg,432,288,N,1,276,78824,79100,MIT_BIH_ECG
0272.jpg,432,288,N,1,286,79100,79386,MIT_BIH_ECG
0273.jpg,432,288,N,1,303,79386,79689,MIT_BIH_ECG
0274.jpg,432,288,N,1,302,79689,79991,MIT_BIH_ECG
0275.jpg,432,288,N,1,299,79991,80290,MIT_BIH_ECG
0276.jpg,432,288,N,1,293,80290,80583,MIT_BIH_ECG
0277.jpg,432,288,N,1,285,80583,80868,MIT_BIH_ECG
0278.jpg,432,288,N,1,284,80868,81152,MIT_BIH_ECG
0279.jpg,432,288,N,1,287,81152,81439,MIT_BIH_ECG
0280.jpg,432,288,N,1,291,81439,81730,MIT_BIH_ECG
0281.jpg,432,288,N,1,300,81730,82030,MIT_BIH_ECG
0282.jpg,432,288,N,1,305,82030,82335,MIT_BIH_ECG
0283.jpg,432,288,N,1,301,82335,82636,MIT_BIH_ECG
0284.jpg,432,288,N,1,291,82636,82927,MIT_BIH_ECG
0285.jpg,432,288,N,1,282,82927,83209,MIT_BIH_ECG
0286.jpg,432,288,N,1,283,83209,83492,MIT_BIH_ECG
0287.jpg,432,288,N,1,302,83492,83794,MIT_BIH_ECG
0288.jpg,432,288,N,1,309,83794,84103,MIT_BIH_ECG
0289.jpg,432,288,N,1,304,84103,84407,MIT_BIH_ECG
0290.jpg,432,288,N,1,302,84407,84709,MIT_BIH_ECG
0291.jpg,432,288,N,1,301,84709,85010,MIT_BIH_ECG
0292.jpg,432,288,N,1,293,85010,85303,MIT_BIH_ECG
0293.jpg,432,288,N,1,277,85303,85580,MIT_BIH_ECG
0294.jpg,432,288,N,1,290,85580,85870,MIT_BIH_ECG
0295.jpg,432,288,N,1,301,85870,86171,MIT_BIH_ECG
0296.jpg,432,288,N,1,307,86171,86478,MIT_BIH_ECG
0297.jpg,432,288,N,1,302,86478,86780,MIT_BIH_ECG
0298.jpg,432,288,N,1,299,86780,87079,MIT_BIH_ECG
0299.jpg,432,288,N,1,285,87079,87364,MIT_BIH_ECG
0300.jpg,432,288,N,1,288,87364,87652,MIT_BIH_ECG
0301.jpg,432,288,N,1,289,87652,87941,MIT_BIH_ECG
0302.jpg,432,288,N,1,291,87941,88232,MIT_BIH_ECG
0303.jpg,432,288,N,1,298,88232,88530,MIT_BIH_ECG
0304.jpg,432,288,N,1,304,88530,88834,MIT_BIH_ECG
0305.jpg,432,288,N,1,301,88834,89135,MIT_BIH_ECG
0306.jpg,432,288,N,1,286,89135,89421,MIT_BIH_ECG
0307.jpg,432,288,N,1,282,89421,89703,MIT_BIH_ECG
0308.jpg,432,288,N,1,285,89703,89988,MIT_BIH_ECG
0309.jpg,432,288,N,1,298,89988,90286,MIT_BIH_ECG
0310.jpg,432,288,N,1,304,90286,90590,MIT_BIH_ECG
0311.jpg,432,288,N,1,295,90590,90885,MIT_BIH_ECG
0312.jpg,432,288,N,1,305,90885,91190,MIT_BIH_ECG
0313.jpg,432,288,N,1,291,91190,91481,MIT_BIH_ECG
0314.jpg,432,288,N,1,280,91481,91761,MIT_BIH_ECG
0315.jpg,432,288,N,1,285,91761,92046,MIT_BIH_ECG
0316.jpg,432,288,N,1,292,92046,92338,MIT_BIH_ECG
0317.jpg,432,288,N,1,295,92338,92633,MIT_BIH_ECG
0318.jpg,432,288,N,1,311,92633,92944,MIT_BIH_ECG
0319.jpg,432,288,N,1,302,92944,93246,MIT_BIH_ECG
0320.jpg,432,288,N,1,288,93246,93534,MIT_BIH_ECG
0321.jpg,432,288,N,1,290,93534,93824,MIT_BIH_ECG
0322.jpg,432,288,N,1,278,93824,94102,MIT_BIH_ECG
0323.jpg,432,288,N,1,293,94102,94395,MIT_BIH_ECG
0324.jpg,432,288,N,1,298,94395,94693,MIT_BIH_ECG
0325.jpg,432,288,N,1,303,94693,94996,MIT_BIH_ECG
0326.jpg,432,288,N,1,302,94996,95298,MIT_BIH_ECG
0327.jpg,432,288,N,1,308,95298,95606,MIT_BIH_ECG
0328.jpg,432,288,N,1,287,95606,95893,MIT_BIH_ECG
0329.jpg,432,288,N,1,278,95893,96171,MIT_BIH_ECG
0330.jpg,432,288,N,1,279,96171,96450,MIT_BIH_ECG
0331.jpg,432,288,N,1,296,96450,96746,MIT_BIH_ECG
0332.jpg,432,288,N,1,304,96746,97050,MIT_BIH_ECG
0333.jpg,432,288,N,1,298,97050,97348,MIT_BIH_ECG
0334.jpg,432,288,N,1,296,97348,97644,MIT_BIH_ECG
0335.jpg,432,288,N,1,292,97644,97936,MIT_BIH_ECG
0336.jpg,432,288,N,1,292,97936,98228,MIT_BIH_ECG
0337.jpg,432,288,N,1,280,98228,98508,MIT_BIH_ECG
0338.jpg,432,288,N,1,281,98508,98789,MIT_BIH_ECG
0339.jpg,432,288,N,1,295,98789,99084,MIT_BIH_ECG
0340.jpg,432,288,N,1,298,99084,99382,MIT_BIH_ECG
0341.jpg,432,288,N,1,197,99382,99579,MIT_BIH_ECG
0342.jpg,432,288,A_A,0,351,99579,99930,MIT_BIH_ECG
0343.jpg,432,288,N,1,288,99930,100218,MIT_BIH_ECG
0344.jpg,432,288,N,1,278,100218,100496,MIT_BIH_ECG
0345.jpg,432,288,N,1,285,100496,100781,MIT_BIH_ECG
0346.jpg,432,288,N,1,290,100781,101071,MIT_BIH_ECG
0347.jpg,432,288,N,1,290,101071,101361,MIT_BIH_ECG
0348.jpg,432,288,N,1,292,101361,101653,MIT_BIH_ECG
0349.jpg,432,288,N,1,288,101653,101941,MIT_BIH_ECG
0350.jpg,432,288,N,1,293,101941,102234,MIT_BIH_ECG
0351.jpg,432,288,N,1,282,102234,102516,MIT_BIH_ECG
0352.jpg,432,288,N,1,277,102516,102793,MIT_BIH_ECG
0353.jpg,432,288,N,1,281,102793,103074,MIT_BIH_ECG
0354.jpg,432,288,N,1,297,103074,103371,MIT_BIH_ECG
0355.jpg,432,288,N,1,298,103371,103669,MIT_BIH_ECG
0356.jpg,432,288,N,1,295,103669,103964,MIT_BIH_ECG
0357.jpg,432,288,N,1,297,103964,104261,MIT_BIH_ECG
0358.jpg,432,288,N,1,284,104261,104545,MIT_BIH_ECG
0359.jpg,432,288,N,1,285,104545,104830,MIT_BIH_ECG
0360.jpg,432,288,N,1,288,104830,105118,MIT_BIH_ECG
0361.jpg,432,288,N,1,289,105118,105407,MIT_BIH_ECG
0362.jpg,432,288,N,1,300,105407,105707,MIT_BIH_ECG
0363.jpg,432,288,N,1,308,105707,106015,MIT_BIH_ECG
0364.jpg,432,288,N,1,299,106015,106314,MIT_BIH_ECG
0365.jpg,432,288,N,1,286,106314,106600,MIT_BIH_ECG
0366.jpg,432,288,N,1,282,106600,106882,MIT_BIH_ECG
0367.jpg,432,288,N,1,277,106882,107159,MIT_BIH_ECG
0368.jpg,432,288,N,1,294,107159,107453,MIT_BIH_ECG
0369.jpg,432,288,N,1,297,107453,107750,MIT_BIH_ECG
0370.jpg,432,288,N,1,295,107750,108045,MIT_BIH_ECG
0371.jpg,432,288,N,1,297,108045,108342,MIT_BIH_ECG
0372.jpg,432,288,N,1,301,108342,108643,MIT_BIH_ECG
0373.jpg,432,288,N,1,283,108643,108926,MIT_BIH_ECG
0374.jpg,432,288,N,1,273,108926,109199,MIT_BIH_ECG
0375.jpg,432,288,N,1,287,109199,109486,MIT_BIH_ECG
0376.jpg,432,288,N,1,286,109486,109772,MIT_BIH_ECG
0377.jpg,432,288,N,1,304,109772,110076,MIT_BIH_ECG
0378.jpg,432,288,N,1,298,110076,110374,MIT_BIH_ECG
0379.jpg,432,288,N,1,299,110374,110673,MIT_BIH_ECG
0380.jpg,432,288,N,1,290,110673,110963,MIT_BIH_ECG
0381.jpg,432,288,N,1,281,110963,111244,MIT_BIH_ECG
0382.jpg,432,288,N,1,280,111244,111524,MIT_BIH_ECG
0383.jpg,432,288,N,1,286,111524,111810,MIT_BIH_ECG
0384.jpg,432,288,N,1,298,111810,112108,MIT_BIH_ECG
0385.jpg,432,288,N,1,297,112108,112405,MIT_BIH_ECG
0386.jpg,432,288,N,1,305,112405,112710,MIT_BIH_ECG
0387.jpg,432,288,N,1,290,112710,113000,MIT_BIH_ECG
0388.jpg,432,288,N,1,281,113000,113281,MIT_BIH_ECG
0389.jpg,432,288,N,1,281,113281,113562,MIT_BIH_ECG
0390.jpg,432,288,N,1,288,113562,113850,MIT_BIH_ECG
0391.jpg,432,288,N,1,292,113850,114142,MIT_BIH_ECG
0392.jpg,432,288,N,1,286,114142,114428,MIT_BIH_ECG
0393.jpg,432,288,N,1,288,114428,114716,MIT_BIH_ECG
0394.jpg,432,288,N,1,284,114716,115000,MIT_BIH_ECG
0395.jpg,432,288,N,1,280,115000,115280,MIT_BIH_ECG
0396.jpg,432,288,N,1,267,115280,115547,MIT_BIH_ECG
0397.jpg,432,288,N,1,268,115547,115815,MIT_BIH_ECG
0398.jpg,432,288,N,1,269,115815,116084,MIT_BIH_ECG
0399.jpg,432,288,N,1,285,116084,116369,MIT_BIH_ECG
0400.jpg,432,288,N,1,285,116369,116654,MIT_BIH_ECG
0401.jpg,432,288,N,1,285,116654,116939,MIT_BIH_ECG
0402.jpg,432,288,N,1,274,116939,117213,MIT_BIH_ECG
0403.jpg,432,288,N,1,281,117213,117494,MIT_BIH_ECG
0404.jpg,432,288,N,1,272,117494,117766,MIT_BIH_ECG
0405.jpg,432,288,N,1,278,117766,118044,MIT_BIH_ECG
0406.jpg,432,288,N,1,279,118044,118323,MIT_BIH_ECG
0407.jpg,432,288,N,1,284,118323,118607,MIT_BIH_ECG
0408.jpg,432,288,N,1,304,118607,118911,MIT_BIH_ECG
0409.jpg,432,288,N,1,304,118911,119215,MIT_BIH_ECG
0410.jpg,432,288,N,1,294,119215,119509,MIT_BIH_ECG
0411.jpg,432,288,N,1,282,119509,119791,MIT_BIH_ECG
0412.jpg,432,288,N,1,286,119791,120077,MIT_BIH_ECG
0413.jpg,432,288,N,1,299,120077,120376,MIT_BIH_ECG
0414.jpg,432,288,N,1,300,120376,120676,MIT_BIH_ECG
0415.jpg,432,288,N,1,314,120676,120990,MIT_BIH_ECG
0416.jpg,432,288,N,1,310,120990,121300,MIT_BIH_ECG
0417.jpg,432,288,N,1,304,121300,121604,MIT_BIH_ECG
0418.jpg,432,288,N,1,285,121604,121889,MIT_BIH_ECG
0419.jpg,432,288,N,1,281,121889,122170,MIT_BIH_ECG
0420.jpg,432,288,N,1,290,122170,122460,MIT_BIH_ECG
0421.jpg,432,288,N,1,290,122460,122750,MIT_BIH_ECG
0422.jpg,432,288,N,1,300,122750,123050,MIT_BIH_ECG
0423.jpg,432,288,N,1,310,123050,123360,MIT_BIH_ECG
0424.jpg,432,288,N,1,304,123360,123664,MIT_BIH_ECG
0425.jpg,432,288,N,1,272,123664,123936,MIT_BIH_ECG
0426.jpg,432,288,N,1,285,123936,124221,MIT_BIH_ECG
0427.jpg,432,288,N,1,286,124221,124507,MIT_BIH_ECG
0428.jpg,432,288,N,1,268,124507,124775,MIT_BIH_ECG
0429.jpg,432,288,N,1,285,124775,125060,MIT_BIH_ECG
0430.jpg,432,288,N,1,295,125060,125355,MIT_BIH_ECG
0431.jpg,432,288,N,1,293,125355,125648,MIT_BIH_ECG
0432.jpg,432,288,N,1,278,125648,125926,MIT_BIH_ECG
0433.jpg,432,288,N,1,277,125926,126203,MIT_BIH_ECG
0434.jpg,432,288,N,1,273,126203,126476,MIT_BIH_ECG
0435.jpg,432,288,N,1,270,126476,126746,MIT_BIH_ECG
0436.jpg,432,288,N,1,279,126746,127025,MIT_BIH_ECG
0437.jpg,432,288,N,1,288,127025,127313,MIT_BIH_ECG
0438.jpg,432,288,N,1,290,127313,127603,MIT_BIH_ECG
0439.jpg,432,288,N,1,289,127603,127892,MIT_BIH_ECG
0440.jpg,432,288,N,1,193,127892,128085,MIT_BIH_ECG
0441.jpg,432,288,A_A,0,338,128085,128423,MIT_BIH_ECG
0442.jpg,432,288,N,1,275,128423,128698,MIT_BIH_ECG
0443.jpg,432,288,N,1,260,128698,128958,MIT_BIH_ECG
0444.jpg,432,288,N,1,272,128958,129230,MIT_BIH_ECG
0445.jpg,432,288,N,1,289,129230,129519,MIT_BIH_ECG
0446.jpg,432,288,N,1,279,129519,129798,MIT_BIH_ECG
0447.jpg,432,288,N,1,259,129798,130057,MIT_BIH_ECG
0448.jpg,432,288,N,1,261,130057,130318,MIT_BIH_ECG
0449.jpg,432,288,N,1,250,130318,130568,MIT_BIH_ECG
0450.jpg,432,288,N,1,250,130568,130818,MIT_BIH_ECG
0451.jpg,432,288,N,1,255,130818,131073,MIT_BIH_ECG
0452.jpg,432,288,N,1,253,131073,131326,MIT_BIH_ECG
0453.jpg,432,288,N,1,258,131326,131584,MIT_BIH_ECG
0454.jpg,432,288,N,1,267,131584,131851,MIT_BIH_ECG
0455.jpg,432,288,N,1,271,131851,132122,MIT_BIH_ECG
0456.jpg,432,288,N,1,259,132122,132381,MIT_BIH_ECG
0457.jpg,432,288,N,1,248,132381,132629,MIT_BIH_ECG
0458.jpg,432,288,N,1,254,132629,132883,MIT_BIH_ECG
0459.jpg,432,288,N,1,249,132883,133132,MIT_BIH_ECG
0460.jpg,432,288,N,1,258,133132,133390,MIT_BIH_ECG
0461.jpg,432,288,N,1,272,133390,133662,MIT_BIH_ECG
0462.jpg,432,288,N,1,271,133662,133933,MIT_BIH_ECG
0463.jpg,432,288,N,1,264,133933,134197,MIT_BIH_ECG
0464.jpg,432,288,N,1,266,134197,134463,MIT_BIH_ECG
0465.jpg,432,288,N,1,274,134463,134737,MIT_BIH_ECG
0466.jpg,432,288,N,1,253,134737,134990,MIT_BIH_ECG
0467.jpg,432,288,N,1,253,134990,135243,MIT_BIH_ECG
0468.jpg,432,288,N,1,261,135243,135504,MIT_BIH_ECG
0469.jpg,432,288,N,1,276,135504,135780,MIT_BIH_ECG
0470.jpg,432,288,N,1,281,135780,136061,MIT_BIH_ECG
0471.jpg,432,288,N,1,289,136061,136350,MIT_BIH_ECG
0472.jpg,432,288,N,1,280,136350,136630,MIT_BIH_ECG
0473.jpg,432,288,N,1,269,136630,136899,MIT_BIH_ECG
0474.jpg,432,288,N,1,271,136899,137170,MIT_BIH_ECG
0475.jpg,432,288,N,1,279,137170,137449,MIT_BIH_ECG
0476.jpg,432,288,N,1,280,137449,137729,MIT_BIH_ECG
0477.jpg,432,288,N,1,279,137729,138008,MIT_BIH_ECG
0478.jpg,432,288,N,1,296,138008,138304,MIT_BIH_ECG
0479.jpg,432,288,N,1,294,138304,138598,MIT_BIH_ECG
0480.jpg,432,288,N,1,290,138598,138888,MIT_BIH_ECG
0481.jpg,432,288,N,1,276,138888,139164,MIT_BIH_ECG
0482.jpg,432,288,N,1,276,139164,139440,MIT_BIH_ECG
0483.jpg,432,288,N,1,279,139440,139719,MIT_BIH_ECG
0484.jpg,432,288,N,1,290,139719,140009,MIT_BIH_ECG
0485.jpg,432,288,N,1,293,140009,140302,MIT_BIH_ECG
0486.jpg,432,288,N,1,297,140302,140599,MIT_BIH_ECG
0487.jpg,432,288,N,1,282,140599,140881,MIT_BIH_ECG
0488.jpg,432,288,N,1,271,140881,141152,MIT_BIH_ECG
0489.jpg,432,288,N,1,271,141152,141423,MIT_BIH_ECG
0490.jpg,432,288,N,1,261,141423,141684,MIT_BIH_ECG
0491.jpg,432,288,N,1,259,141684,141943,MIT_BIH_ECG
0492.jpg,432,288,N,1,264,141943,142207,MIT_BIH_ECG
0493.jpg,432,288,N,1,272,142207,142479,MIT_BIH_ECG
0494.jpg,432,288,N,1,268,142479,142747,MIT_BIH_ECG
0495.jpg,432,288,N,1,263,142747,143010,MIT_BIH_ECG
0496.jpg,432,288,N,1,255,143010,143265,MIT_BIH_ECG
0497.jpg,432,288,N,1,250,143265,143515,MIT_BIH_ECG
0498.jpg,432,288,N,1,251,143515,143766,MIT_BIH_ECG
0499.jpg,432,288,N,1,259,143766,144025,MIT_BIH_ECG
0500.jpg,432,288,N,1,261,144025,144286,MIT_BIH_ECG
0501.jpg,432,288,N,1,271,144286,144557,MIT_BIH_ECG
0502.jpg,432,288,N,1,275,144557,144832,MIT_BIH_ECG
0503.jpg,432,288,N,1,279,144832,145111,MIT_BIH_ECG
0504.jpg,432,288,N,1,270,145111,145381,MIT_BIH_ECG
0505.jpg,432,288,N,1,266,145381,145647,MIT_BIH_ECG
0506.jpg,432,288,N,1,255,145647,145902,MIT_BIH_ECG
0507.jpg,432,288,N,1,268,145902,146170,MIT_BIH_ECG
0508.jpg,432,288,N,1,275,146170,146445,MIT_BIH_ECG
0509.jpg,432,288,N,1,292,146445,146737,MIT_BIH_ECG
0510.jpg,432,288,N,1,276,146737,147013,MIT_BIH_ECG
0511.jpg,432,288,N,1,277,147013,147290,MIT_BIH_ECG
0512.jpg,432,288,N,1,275,147290,147565,MIT_BIH_ECG
0513.jpg,432,288,N,1,267,147565,147832,MIT_BIH_ECG
0514.jpg,432,288,N,1,267,147832,148099,MIT_BIH_ECG
0515.jpg,432,288,N,1,264,148099,148363,MIT_BIH_ECG
0516.jpg,432,288,N,1,274,148363,148637,MIT_BIH_ECG
0517.jpg,432,288,N,1,279,148637,148916,MIT_BIH_ECG
0518.jpg,432,288,N,1,288,148916,149204,MIT_BIH_ECG
0519.jpg,432,288,N,1,284,149204,149488,MIT_BIH_ECG
0520.jpg,432,288,N,1,280,149488,149768,MIT_BIH_ECG
0521.jpg,432,288,N,1,262,149768,150030,MIT_BIH_ECG
0522.jpg,432,288,N,1,273,150030,150303,MIT_BIH_ECG
0523.jpg,432,288,N,1,272,150303,150575,MIT_BIH_ECG
0524.jpg,432,288,N,1,274,150575,150849,MIT_BIH_ECG
0525.jpg,432,288,N,1,273,150849,151122,MIT_BIH_ECG
0526.jpg,432,288,N,1,285,151122,151407,MIT_BIH_ECG
0527.jpg,432,288,N,1,293,151407,151700,MIT_BIH_ECG
0528.jpg,432,288,N,1,274,151700,151974,MIT_BIH_ECG
0529.jpg,432,288,N,1,263,151974,152237,MIT_BIH_ECG
0530.jpg,432,288,N,1,273,152237,152510,MIT_BIH_ECG
0531.jpg,432,288,N,1,271,152510,152781,MIT_BIH_ECG
0532.jpg,432,288,N,1,286,152781,153067,MIT_BIH_ECG
0533.jpg,432,288,N,1,295,153067,153362,MIT_BIH_ECG
0534.jpg,432,288,N,1,282,153362,153644,MIT_BIH_ECG
0535.jpg,432,288,N,1,278,153644,153922,MIT_BIH_ECG
0536.jpg,432,288,N,1,271,153922,154193,MIT_BIH_ECG
0537.jpg,432,288,N,1,277,154193,154470,MIT_BIH_ECG
0538.jpg,432,288,N,1,271,154470,154741,MIT_BIH_ECG
0539.jpg,432,288,N,1,268,154741,155009,MIT_BIH_ECG
0540.jpg,432,288,N,1,282,155009,155291,MIT_BIH_ECG
0541.jpg,432,288,N,1,297,155291,155588,MIT_BIH_ECG
0542.jpg,432,288,N,1,277,155588,155865,MIT_BIH_ECG
0543.jpg,432,288,N,1,267,155865,156132,MIT_BIH_ECG
0544.jpg,432,288,N,1,263,156132,156395,MIT_BIH_ECG
0545.jpg,432,288,N,1,253,156395,156648,MIT_BIH_ECG
0546.jpg,432,288,N,1,258,156648,156906,MIT_BIH_ECG
0547.jpg,432,288,N,1,262,156906,157168,MIT_BIH_ECG
0548.jpg,432,288,N,1,262,157168,157430,MIT_BIH_ECG
0549.jpg,432,288,N,1,265,157430,157695,MIT_BIH_ECG
0550.jpg,432,288,N,1,265,157695,157960,MIT_BIH_ECG
0551.jpg,432,288,N,1,273,157960,158233,MIT_BIH_ECG
0552.jpg,432,288,N,1,256,158233,158489,MIT_BIH_ECG
0553.jpg,432,288,N,1,241,158489,158730,MIT_BIH_ECG
0554.jpg,432,288,N,1,244,158730,158974,MIT_BIH_ECG
0555.jpg,432,288,N,1,251,158974,159225,MIT_BIH_ECG
0556.jpg,432,288,N,1,254,159225,159479,MIT_BIH_ECG
0557.jpg,432,288,N,1,259,159479,159738,MIT_BIH_ECG
0558.jpg,432,288,N,1,263,159738,160001,MIT_BIH_ECG
0559.jpg,432,288,N,1,259,160001,160260,MIT_BIH_ECG
0560.jpg,432,288,N,1,247,160260,160507,MIT_BIH_ECG
0561.jpg,432,288,N,1,248,160507,160755,MIT_BIH_ECG
0562.jpg,432,288,N,1,250,160755,161005,MIT_BIH_ECG
0563.jpg,432,288,N,1,249,161005,161254,MIT_BIH_ECG
0564.jpg,432,288,N,1,245,161254,161499,MIT_BIH_ECG
0565.jpg,432,288,N,1,265,161499,161764,MIT_BIH_ECG
0566.jpg,432,288,N,1,271,161764,162035,MIT_BIH_ECG
0567.jpg,432,288,N,1,273,162035,162308,MIT_BIH_ECG
0568.jpg,432,288,N,1,265,162308,162573,MIT_BIH_ECG
0569.jpg,432,288,N,1,262,162573,162835,MIT_BIH_ECG
0570.jpg,432,288,N,1,258,162835,163093,MIT_BIH_ECG
0571.jpg,432,288,N,1,269,163093,163362,MIT_BIH_ECG
0572.jpg,432,288,N,1,267,163362,163629,MIT_BIH_ECG
0573.jpg,432,288,N,1,270,163629,163899,MIT_BIH_ECG
0574.jpg,432,288,N,1,283,163899,164182,MIT_BIH_ECG
0575.jpg,432,288,N,1,279,164182,164461,MIT_BIH_ECG
0576.jpg,432,288,N,1,270,164461,164731,MIT_BIH_ECG
0577.jpg,432,288,N,1,260,164731,164991,MIT_BIH_ECG
0578.jpg,432,288,N,1,255,164991,165246,MIT_BIH_ECG
0579.jpg,432,288,N,1,253,165246,165499,MIT_BIH_ECG
0580.jpg,432,288,N,1,257,165499,165756,MIT_BIH_ECG
0581.jpg,432,288,N,1,276,165756,166032,MIT_BIH_ECG
0582.jpg,432,288,N,1,269,166032,166301,MIT_BIH_ECG
0583.jpg,432,288,N,1,269,166301,166570,MIT_BIH_ECG
0584.jpg,432,288,N,1,271,166570,166841,MIT_BIH_ECG
0585.jpg,432,288,N,1,270,166841,167111,MIT_BIH_ECG
0586.jpg,432,288,N,1,260,167111,167371,MIT_BIH_ECG
0587.jpg,432,288,N,1,270,167371,167641,MIT_BIH_ECG
0588.jpg,432,288,N,1,271,167641,167912,MIT_BIH_ECG
0589.jpg,432,288,N,1,279,167912,168191,MIT_BIH_ECG
0590.jpg,432,288,N,1,293,168191,168484,MIT_BIH_ECG
0591.jpg,432,288,N,1,300,168484,168784,MIT_BIH_ECG
0592.jpg,432,288,N,1,290,168784,169074,MIT_BIH_ECG
0593.jpg,432,288,N,1,275,169074,169349,MIT_BIH_ECG
0594.jpg,432,288,N,1,280,169349,169629,MIT_BIH_ECG
0595.jpg,432,288,N,1,278,169629,169907,MIT_BIH_ECG
0596.jpg,432,288,N,1,294,169907,170201,MIT_BIH_ECG
0597.jpg,432,288,N,1,294,170201,170495,MIT_BIH_ECG
0598.jpg,432,288,N,1,224,170495,170719,MIT_BIH_ECG
0599.jpg,432,288,A_A,0,355,170719,171074,MIT_BIH_ECG
0600.jpg,432,288,N,1,297,171074,171371,MIT_BIH_ECG
0601.jpg,432,288,N,1,281,171371,171652,MIT_BIH_ECG
0602.jpg,432,288,N,1,269,171652,171921,MIT_BIH_ECG
0603.jpg,432,288,N,1,278,171921,172199,MIT_BIH_ECG
0604.jpg,432,288,N,1,282,172199,172481,MIT_BIH_ECG
0605.jpg,432,288,N,1,295,172481,172776,MIT_BIH_ECG
0606.jpg,432,288,N,1,291,172776,173067,MIT_BIH_ECG
0607.jpg,432,288,N,1,284,173067,173351,MIT_BIH_ECG
0608.jpg,432,288,N,1,278,173351,173629,MIT_BIH_ECG
0609.jpg,432,288,N,1,278,173629,173907,MIT_BIH_ECG
0610.jpg,432,288,N,1,269,173907,174176,MIT_BIH_ECG
0611.jpg,432,288,N,1,275,174176,174451,MIT_BIH_ECG
0612.jpg,432,288,N,1,286,174451,174737,MIT_BIH_ECG
0613.jpg,432,288,N,1,286,174737,175023,MIT_BIH_ECG
0614.jpg,432,288,N,1,300,175023,175323,MIT_BIH_ECG
0615.jpg,432,288,N,1,285,175323,175608,MIT_BIH_ECG
0616.jpg,432,288,N,1,269,175608,175877,MIT_BIH_ECG
0617.jpg,432,288,N,1,268,175877,176145,MIT_BIH_ECG
0618.jpg,432,288,N,1,282,176145,176427,MIT_BIH_ECG
0619.jpg,432,288,N,1,271,176427,176698,MIT_BIH_ECG
0620.jpg,432,288,N,1,277,176698,176975,MIT_BIH_ECG
0621.jpg,432,288,N,1,273,176975,177248,MIT_BIH_ECG
0622.jpg,432,288,N,1,275,177248,177523,MIT_BIH_ECG
0623.jpg,432,288,N,1,274,177523,177797,MIT_BIH_ECG
0624.jpg,432,288,N,1,262,177797,178059,MIT_BIH_ECG
0625.jpg,432,288,N,1,257,178059,178316,MIT_BIH_ECG
0626.jpg,432,288,N,1,262,178316,178578,MIT_BIH_ECG
0627.jpg,432,288,N,1,263,178578,178841,MIT_BIH_ECG
0628.jpg,432,288,N,1,276,178841,179117,MIT_BIH_ECG
0629.jpg,432,288,N,1,271,179117,179388,MIT_BIH_ECG
0630.jpg,432,288,N,1,274,179388,179662,MIT_BIH_ECG
0631.jpg,432,288,N,1,265,179662,179927,MIT_BIH_ECG
0632.jpg,432,288,N,1,255,179927,180182,MIT_BIH_ECG
0633.jpg,432,288,N,1,261,180182,180443,MIT_BIH_ECG
0634.jpg,432,288,N,1,262,180443,180705,MIT_BIH_ECG
0635.jpg,432,288,N,1,259,180705,180964,MIT_BIH_ECG
0636.jpg,432,288,N,1,272,180964,181236,MIT_BIH_ECG
0637.jpg,432,288,N,1,287,181236,181523,MIT_BIH_ECG
0638.jpg,432,288,N,1,288,181523,181811,MIT_BIH_ECG
0639.jpg,432,288,N,1,273,181811,182084,MIT_BIH_ECG
0640.jpg,432,288,N,1,269,182084,182353,MIT_BIH_ECG
0641.jpg,432,288,N,1,271,182353,182624,MIT_BIH_ECG
0642.jpg,432,288,N,1,272,182624,182896,MIT_BIH_ECG
0643.jpg,432,288,N,1,285,182896,183181,MIT_BIH_ECG
0644.jpg,432,288,N,1,294,183181,183475,MIT_BIH_ECG
0645.jpg,432,288,N,1,303,183475,183778,MIT_BIH_ECG
0646.jpg,432,288,N,1,293,183778,184071,MIT_BIH_ECG
0647.jpg,432,288,N,1,290,184071,184361,MIT_BIH_ECG
0648.jpg,432,288,N,1,288,184361,184649,MIT_BIH_ECG
0649.jpg,432,288,N,1,284,184649,184933,MIT_BIH_ECG
0650.jpg,432,288,N,1,280,184933,185213,MIT_BIH_ECG
0651.jpg,432,288,N,1,297,185213,185510,MIT_BIH_ECG
0652.jpg,432,288,N,1,318,185510,185828,MIT_BIH_ECG
0653.jpg,432,288,N,1,309,185828,186137,MIT_BIH_ECG
0654.jpg,432,288,N,1,291,186137,186428,MIT_BIH_ECG
0655.jpg,432,288,N,1,289,186428,186717,MIT_BIH_ECG
0656.jpg,432,288,N,1,288,186717,187005,MIT_BIH_ECG
0657.jpg,432,288,N,1,286,187005,187291,MIT_BIH_ECG
0658.jpg,432,288,N,1,286,187291,187577,MIT_BIH_ECG
0659.jpg,432,288,N,1,295,187577,187872,MIT_BIH_ECG
0660.jpg,432,288,N,1,307,187872,188179,MIT_BIH_ECG
0661.jpg,432,288,N,1,302,188179,188481,MIT_BIH_ECG
0662.jpg,432,288,N,1,282,188481,188763,MIT_BIH_ECG
0663.jpg,432,288,N,1,280,188763,189043,MIT_BIH_ECG
0664.jpg,432,288,N,1,287,189043,189330,MIT_BIH_ECG
0665.jpg,432,288,N,1,294,189330,189624,MIT_BIH_ECG
0666.jpg,432,288,N,1,305,189624,189929,MIT_BIH_ECG
0667.jpg,432,288,N,1,299,189929,190228,MIT_BIH_ECG
0668.jpg,432,288,N,1,301,190228,190529,MIT_BIH_ECG
0669.jpg,432,288,N,1,291,190529,190820,MIT_BIH_ECG
0670.jpg,432,288,N,1,292,190820,191112,MIT_BIH_ECG
0671.jpg,432,288,N,1,283,191112,191395,MIT_BIH_ECG
0672.jpg,432,288,N,1,279,191395,191674,MIT_BIH_ECG
0673.jpg,432,288,N,1,303,191674,191977,MIT_BIH_ECG
0674.jpg,432,288,N,1,304,191977,192281,MIT_BIH_ECG
0675.jpg,432,288,N,1,294,192281,192575,MIT_BIH_ECG
0676.jpg,432,288,N,1,287,192575,192862,MIT_BIH_ECG
0677.jpg,432,288,N,1,284,192862,193146,MIT_BIH_ECG
0678.jpg,432,288,N,1,277,193146,193423,MIT_BIH_ECG
0679.jpg,432,288,N,1,280,193423,193703,MIT_BIH_ECG
0680.jpg,432,288,N,1,291,193703,193994,MIT_BIH_ECG
0681.jpg,432,288,N,1,287,193994,194281,MIT_BIH_ECG
0682.jpg,432,288,N,1,293,194281,194574,MIT_BIH_ECG
0683.jpg,432,288,N,1,294,194574,194868,MIT_BIH_ECG
0684.jpg,432,288,N,1,288,194868,195156,MIT_BIH_ECG
0685.jpg,432,288,N,1,270,195156,195426,MIT_BIH_ECG
0686.jpg,432,288,N,1,275,195426,195701,MIT_BIH_ECG
0687.jpg,432,288,N,1,277,195701,195978,MIT_BIH_ECG
0688.jpg,432,288,N,1,290,195978,196268,MIT_BIH_ECG
0689.jpg,432,288,N,1,292,196268,196560,MIT_BIH_ECG
0690.jpg,432,288,N,1,287,196560,196847,MIT_BIH_ECG
0691.jpg,432,288,N,1,285,196847,197132,MIT_BIH_ECG
0692.jpg,432,288,N,1,282,197132,197414,MIT_BIH_ECG
0693.jpg,432,288,N,1,271,197414,197685,MIT_BIH_ECG
0694.jpg,432,288,N,1,265,197685,197950,MIT_BIH_ECG
0695.jpg,432,288,N,1,274,197950,198224,MIT_BIH_ECG
0696.jpg,432,288,N,1,280,198224,198504,MIT_BIH_ECG
0697.jpg,432,288,N,1,287,198504,198791,MIT_BIH_ECG
0698.jpg,432,288,N,1,284,198791,199075,MIT_BIH_ECG
0699.jpg,432,288,N,1,278,199075,199353,MIT_BIH_ECG
0700.jpg,432,288,N,1,266,199353,199619,MIT_BIH_ECG
0701.jpg,432,288,N,1,275,199619,199894,MIT_BIH_ECG
0702.jpg,432,288,N,1,267,199894,200161,MIT_BIH_ECG
0703.jpg,432,288,N,1,273,200161,200434,MIT_BIH_ECG
0704.jpg,432,288,N,1,280,200434,200714,MIT_BIH_ECG
0705.jpg,432,288,N,1,279,200714,200993,MIT_BIH_ECG
0706.jpg,432,288,N,1,278,200993,201271,MIT_BIH_ECG
0707.jpg,432,288,N,1,274,201271,201545,MIT_BIH_ECG
0708.jpg,432,288,N,1,261,201545,201806,MIT_BIH_ECG
0709.jpg,432,288,N,1,261,201806,202067,MIT_BIH_ECG
0710.jpg,432,288,N,1,272,202067,202339,MIT_BIH_ECG
0711.jpg,432,288,N,1,275,202339,202614,MIT_BIH_ECG
0712.jpg,432,288,N,1,282,202614,202896,MIT_BIH_ECG
0713.jpg,432,288,N,1,286,202896,203182,MIT_BIH_ECG
0714.jpg,432,288,N,1,286,203182,203468,MIT_BIH_ECG
0715.jpg,432,288,N,1,273,203468,203741,MIT_BIH_ECG
0716.jpg,432,288,N,1,280,203741,204021,MIT_BIH_ECG
0717.jpg,432,288,N,1,278,204021,204299,MIT_BIH_ECG
0718.jpg,432,288,N,1,275,204299,204574,MIT_BIH_ECG
0719.jpg,432,288,N,1,280,204574,204854,MIT_BIH_ECG
0720.jpg,432,288,N,1,304,204854,205158,MIT_BIH_ECG
0721.jpg,432,288,N,1,301,205158,205459,MIT_BIH_ECG
0722.jpg,432,288,N,1,278,205459,205737,MIT_BIH_ECG
0723.jpg,432,288,N,1,279,205737,206016,MIT_BIH_ECG
0724.jpg,432,288,N,1,272,206016,206288,MIT_BIH_ECG
0725.jpg,432,288,N,1,279,206288,206567,MIT_BIH_ECG
0726.jpg,432,288,N,1,277,206567,206844,MIT_BIH_ECG
0727.jpg,432,288,N,1,286,206844,207130,MIT_BIH_ECG
0728.jpg,432,288,N,1,291,207130,207421,MIT_BIH_ECG
0729.jpg,432,288,N,1,303,207421,207724,MIT_BIH_ECG
0730.jpg,432,288,N,1,280,207724,208004,MIT_BIH_ECG
0731.jpg,432,288,N,1,273,208004,208277,MIT_BIH_ECG
0732.jpg,432,288,N,1,271,208277,208548,MIT_BIH_ECG
0733.jpg,432,288,N,1,274,208548,208822,MIT_BIH_ECG
0734.jpg,432,288,N,1,278,208822,209100,MIT_BIH_ECG
0735.jpg,432,288,N,1,292,209100,209392,MIT_BIH_ECG
0736.jpg,432,288,N,1,291,209392,209683,MIT_BIH_ECG
0737.jpg,432,288,N,1,290,209683,209973,MIT_BIH_ECG
0738.jpg,432,288,N,1,283,209973,210256,MIT_BIH_ECG
0739.jpg,432,288,N,1,278,210256,210534,MIT_BIH_ECG
0740.jpg,432,288,N,1,275,210534,210809,MIT_BIH_ECG
0741.jpg,432,288,N,1,276,210809,211085,MIT_BIH_ECG
0742.jpg,432,288,N,1,279,211085,211364,MIT_BIH_ECG
0743.jpg,432,288,N,1,290,211364,211654,MIT_BIH_ECG
0744.jpg,432,288,N,1,297,211654,211951,MIT_BIH_ECG
0745.jpg,432,288,N,1,277,211951,212228,MIT_BIH_ECG
0746.jpg,432,288,N,1,274,212228,212502,MIT_BIH_ECG
0747.jpg,432,288,N,1,275,212502,212777,MIT_BIH_ECG
0748.jpg,432,288,N,1,281,212777,213058,MIT_BIH_ECG
0749.jpg,432,288,N,1,268,213058,213326,MIT_BIH_ECG
0750.jpg,432,288,N,1,280,213326,213606,MIT_BIH_ECG
0751.jpg,432,288,N,1,288,213606,213894,MIT_BIH_ECG
0752.jpg,432,288,N,1,287,213894,214181,MIT_BIH_ECG
0753.jpg,432,288,N,1,284,214181,214465,MIT_BIH_ECG
0754.jpg,432,288,N,1,273,214465,214738,MIT_BIH_ECG
0755.jpg,432,288,N,1,267,214738,215005,MIT_BIH_ECG
0756.jpg,432,288,N,1,275,215005,215280,MIT_BIH_ECG
0757.jpg,432,288,N,1,283,215280,215563,MIT_BIH_ECG
0758.jpg,432,288,N,1,287,215563,215850,MIT_BIH_ECG
0759.jpg,432,288,N,1,291,215850,216141,MIT_BIH_ECG
0760.jpg,432,288,N,1,290,216141,216431,MIT_BIH_ECG
0761.jpg,432,288,N,1,279,216431,216710,MIT_BIH_ECG
0762.jpg,432,288,N,1,280,216710,216990,MIT_BIH_ECG
0763.jpg,432,288,N,1,278,216990,217268,MIT_BIH_ECG
0764.jpg,432,288,N,1,279,217268,217547,MIT_BIH_ECG
0765.jpg,432,288,N,1,277,217547,217824,MIT_BIH_ECG
0766.jpg,432,288,N,1,298,217824,218122,MIT_BIH_ECG
0767.jpg,432,288,N,1,294,218122,218416,MIT_BIH_ECG
0768.jpg,432,288,N,1,287,218416,218703,MIT_BIH_ECG
0769.jpg,432,288,N,1,269,218703,218972,MIT_BIH_ECG
0770.jpg,432,288,N,1,274,218972,219246,MIT_BIH_ECG
0771.jpg,432,288,N,1,283,219246,219529,MIT_BIH_ECG
0772.jpg,432,288,N,1,284,219529,219813,MIT_BIH_ECG
0773.jpg,432,288,N,1,285,219813,220098,MIT_BIH_ECG
0774.jpg,432,288,N,1,293,220098,220391,MIT_BIH_ECG
0775.jpg,432,288,N,1,300,220391,220691,MIT_BIH_ECG
0776.jpg,432,288,N,1,286,220691,220977,MIT_BIH_ECG
0777.jpg,432,288,N,1,275,220977,221252,MIT_BIH_ECG
0778.jpg,432,288,N,1,275,221252,221527,MIT_BIH_ECG
0779.jpg,432,288,N,1,277,221527,221804,MIT_BIH_ECG
0780.jpg,432,288,N,1,277,221804,222081,MIT_BIH_ECG
0781.jpg,432,288,N,1,294,222081,222375,MIT_BIH_ECG
0782.jpg,432,288,N,1,291,222375,222666,MIT_BIH_ECG
0783.jpg,432,288,N,1,285,222666,222951,MIT_BIH_ECG
0784.jpg,432,288,N,1,276,222951,223227,MIT_BIH_ECG
0785.jpg,432,288,N,1,280,223227,223507,MIT_BIH_ECG
0786.jpg,432,288,N,1,276,223507,223783,MIT_BIH_ECG
0787.jpg,432,288,N,1,264,223783,224047,MIT_BIH_ECG
0788.jpg,432,288,N,1,281,224047,224328,MIT_BIH_ECG
0789.jpg,432,288,N,1,293,224328,224621,MIT_BIH_ECG
0790.jpg,432,288,N,1,294,224621,224915,MIT_BIH_ECG
0791.jpg,432,288,N,1,280,224915,225195,MIT_BIH_ECG
0792.jpg,432,288,N,1,277,225195,225472,MIT_BIH_ECG
0793.jpg,432,288,N,1,271,225472,225743,MIT_BIH_ECG
0794.jpg,432,288,N,1,281,225743,226024,MIT_BIH_ECG
0795.jpg,432,288,N,1,272,226024,226296,MIT_BIH_ECG
0796.jpg,432,288,N,1,277,226296,226573,MIT_BIH_ECG
0797.jpg,432,288,N,1,290,226573,226863,MIT_BIH_ECG
0798.jpg,432,288,N,1,281,226863,227144,MIT_BIH_ECG
0799.jpg,432,288,N,1,283,227144,227427,MIT_BIH_ECG
0800.jpg,432,288,N,1,275,227427,227702,MIT_BIH_ECG
0801.jpg,432,288,N,1,273,227702,227975,MIT_BIH_ECG
0802.jpg,432,288,N,1,263,227975,228238,MIT_BIH_ECG
0803.jpg,432,288,N,1,278,228238,228516,MIT_BIH_ECG
0804.jpg,432,288,N,1,292,228516,228808,MIT_BIH_ECG
0805.jpg,432,288,N,1,286,228808,229094,MIT_BIH_ECG
0806.jpg,432,288,N,1,282,229094,229376,MIT_BIH_ECG
0807.jpg,432,288,N,1,284,229376,229660,MIT_BIH_ECG
0808.jpg,432,288,N,1,276,229660,229936,MIT_BIH_ECG
0809.jpg,432,288,N,1,278,229936,230214,MIT_BIH_ECG
0810.jpg,432,288,N,1,271,230214,230485,MIT_BIH_ECG
0811.jpg,432,288,N,1,276,230485,230761,MIT_BIH_ECG
0812.jpg,432,288,N,1,297,230761,231058,MIT_BIH_ECG
0813.jpg,432,288,N,1,299,231058,231357,MIT_BIH_ECG
0814.jpg,432,288,N,1,281,231357,231638,MIT_BIH_ECG
0815.jpg,432,288,N,1,275,231638,231913,MIT_BIH_ECG
0816.jpg,432,288,N,1,277,231913,232190,MIT_BIH_ECG
0817.jpg,432,288,N,1,269,232190,232459,MIT_BIH_ECG
0818.jpg,432,288,N,1,273,232459,232732,MIT_BIH_ECG
0819.jpg,432,288,N,1,284,232732,233016,MIT_BIH_ECG
0820.jpg,432,288,N,1,285,233016,233301,MIT_BIH_ECG
0821.jpg,432,288,N,1,287,233301,233588,MIT_BIH_ECG
0822.jpg,432,288,N,1,287,233588,233875,MIT_BIH_ECG
0823.jpg,432,288,N,1,276,233875,234151,MIT_BIH_ECG
0824.jpg,432,288,N,1,264,234151,234415,MIT_BIH_ECG
0825.jpg,432,288,N,1,269,234415,234684,MIT_BIH_ECG
0826.jpg,432,288,N,1,275,234684,234959,MIT_BIH_ECG
0827.jpg,432,288,N,1,290,234959,235249,MIT_BIH_ECG
0828.jpg,432,288,N,1,298,235249,235547,MIT_BIH_ECG
0829.jpg,432,288,N,1,281,235547,235828,MIT_BIH_ECG
0830.jpg,432,288,N,1,280,235828,236108,MIT_BIH_ECG
0831.jpg,432,288,N,1,282,236108,236390,MIT_BIH_ECG
0832.jpg,432,288,N,1,274,236390,236664,MIT_BIH_ECG
0833.jpg,432,288,N,1,263,236664,236927,MIT_BIH_ECG
0834.jpg,432,288,N,1,278,236927,237205,MIT_BIH_ECG
0835.jpg,432,288,N,1,290,237205,237495,MIT_BIH_ECG
0836.jpg,432,288,N,1,288,237495,237783,MIT_BIH_ECG
0837.jpg,432,288,N,1,287,237783,238070,MIT_BIH_ECG
0838.jpg,432,288,N,1,273,238070,238343,MIT_BIH_ECG
0839.jpg,432,288,N,1,267,238343,238610,MIT_BIH_ECG
0840.jpg,432,288,N,1,274,238610,238884,MIT_BIH_ECG
0841.jpg,432,288,N,1,273,238884,239157,MIT_BIH_ECG
0842.jpg,432,288,N,1,276,239157,239433,MIT_BIH_ECG
0843.jpg,432,288,N,1,284,239433,239717,MIT_BIH_ECG
0844.jpg,432,288,N,1,279,239717,239996,MIT_BIH_ECG
0845.jpg,432,288,N,1,270,239996,240266,MIT_BIH_ECG
0846.jpg,432,288,N,1,275,240266,240541,MIT_BIH_ECG
0847.jpg,432,288,N,1,268,240541,240809,MIT_BIH_ECG
0848.jpg,432,288,N,1,256,240809,241065,MIT_BIH_ECG
0849.jpg,432,288,N,1,253,241065,241318,MIT_BIH_ECG
0850.jpg,432,288,N,1,270,241318,241588,MIT_BIH_ECG
0851.jpg,432,288,N,1,267,241588,241855,MIT_BIH_ECG
0852.jpg,432,288,N,1,259,241855,242114,MIT_BIH_ECG
0853.jpg,432,288,N,1,259,242114,242373,MIT_BIH_ECG
0854.jpg,432,288,N,1,259,242373,242632,MIT_BIH_ECG
0855.jpg,432,288,N,1,247,242632,242879,MIT_BIH_ECG
0856.jpg,432,288,N,1,253,242879,243132,MIT_BIH_ECG
0857.jpg,432,288,N,1,256,243132,243388,MIT_BIH_ECG
0858.jpg,432,288,N,1,255,243388,243643,MIT_BIH_ECG
0859.jpg,432,288,N,1,265,243643,243908,MIT_BIH_ECG
0860.jpg,432,288,N,1,283,243908,244191,MIT_BIH_ECG
0861.jpg,432,288,N,1,270,244191,244461,MIT_BIH_ECG
0862.jpg,432,288,N,1,268,244461,244729,MIT_BIH_ECG
0863.jpg,432,288,N,1,255,244729,244984,MIT_BIH_ECG
0864.jpg,432,288,N,1,262,244984,245246,MIT_BIH_ECG
0865.jpg,432,288,N,1,269,245246,245515,MIT_BIH_ECG
0866.jpg,432,288,N,1,276,245515,245791,MIT_BIH_ECG
0867.jpg,432,288,N,1,274,245791,246065,MIT_BIH_ECG
0868.jpg,432,288,N,1,287,246065,246352,MIT_BIH_ECG
0869.jpg,432,288,N,1,295,246352,246647,MIT_BIH_ECG
0870.jpg,432,288,N,1,288,246647,246935,MIT_BIH_ECG
0871.jpg,432,288,N,1,266,246935,247201,MIT_BIH_ECG
0872.jpg,432,288,N,1,268,247201,247469,MIT_BIH_ECG
0873.jpg,432,288,N,1,273,247469,247742,MIT_BIH_ECG
0874.jpg,432,288,N,1,275,247742,248017,MIT_BIH_ECG
0875.jpg,432,288,N,1,283,248017,248300,MIT_BIH_ECG
0876.jpg,432,288,N,1,286,248300,248586,MIT_BIH_ECG
0877.jpg,432,288,N,1,292,248586,248878,MIT_BIH_ECG
0878.jpg,432,288,N,1,280,248878,249158,MIT_BIH_ECG
0879.jpg,432,288,N,1,275,249158,249433,MIT_BIH_ECG
0880.jpg,432,288,N,1,273,249433,249706,MIT_BIH_ECG
0881.jpg,432,288,N,1,282,249706,249988,MIT_BIH_ECG
0882.jpg,432,288,N,1,285,249988,250273,MIT_BIH_ECG
0883.jpg,432,288,N,1,285,250273,250558,MIT_BIH_ECG
0884.jpg,432,288,N,1,300,250558,250858,MIT_BIH_ECG
0885.jpg,432,288,N,1,302,250858,251160,MIT_BIH_ECG
0886.jpg,432,288,N,1,281,251160,251441,MIT_BIH_ECG
0887.jpg,432,288,N,1,269,251441,251710,MIT_BIH_ECG
0888.jpg,432,288,N,1,284,251710,251994,MIT_BIH_ECG
0889.jpg,432,288,N,1,291,251994,252285,MIT_BIH_ECG
0890.jpg,432,288,N,1,299,252285,252584,MIT_BIH_ECG
0891.jpg,432,288,N,1,284,252584,252868,MIT_BIH_ECG
0892.jpg,432,288,N,1,291,252868,253159,MIT_BIH_ECG
0893.jpg,432,288,N,1,297,253159,253456,MIT_BIH_ECG
0894.jpg,432,288,N,1,285,253456,253741,MIT_BIH_ECG
0895.jpg,432,288,N,1,269,253741,254010,MIT_BIH_ECG
0896.jpg,432,288,N,1,272,254010,254282,MIT_BIH_ECG
0897.jpg,432,288,N,1,303,254282,254585,MIT_BIH_ECG
0898.jpg,432,288,N,1,306,254585,254891,MIT_BIH_ECG
0899.jpg,432,288,N,1,279,254891,255170,MIT_BIH_ECG
0900.jpg,432,288,N,1,283,255170,255453,MIT_BIH_ECG
0901.jpg,432,288,N,1,285,255453,255738,MIT_BIH_ECG
0902.jpg,432,288,N,1,289,255738,256027,MIT_BIH_ECG
0903.jpg,432,288,N,1,268,256027,256295,MIT_BIH_ECG
0904.jpg,432,288,N,1,277,256295,256572,MIT_BIH_ECG
0905.jpg,432,288,N,1,288,256572,256860,MIT_BIH_ECG
0906.jpg,432,288,N,1,297,256860,257157,MIT_BIH_ECG
0907.jpg,432,288,N,1,282,257157,257439,MIT_BIH_ECG
0908.jpg,432,288,N,1,271,257439,257710,MIT_BIH_ECG
0909.jpg,432,288,N,1,256,257710,257966,MIT_BIH_ECG
0910.jpg,432,288,N,1,260,257966,258226,MIT_BIH_ECG
0911.jpg,432,288,N,1,252,258226,258478,MIT_BIH_ECG
0912.jpg,432,288,N,1,259,258478,258737,MIT_BIH_ECG
0913.jpg,432,288,N,1,268,258737,259005,MIT_BIH_ECG
0914.jpg,432,288,N,1,275,259005,259280,MIT_BIH_ECG
0915.jpg,432,288,N,1,261,259280,259541,MIT_BIH_ECG
0916.jpg,432,288,N,1,270,259541,259811,MIT_BIH_ECG
0917.jpg,432,288,N,1,265,259811,260076,MIT_BIH_ECG
0918.jpg,432,288,N,1,258,260076,260334,MIT_BIH_ECG
0919.jpg,432,288,N,1,251,260334,260585,MIT_BIH_ECG
0920.jpg,432,288,N,1,267,260585,260852,MIT_BIH_ECG
0921.jpg,432,288,N,1,280,260852,261132,MIT_BIH_ECG
0922.jpg,432,288,N,1,285,261132,261417,MIT_BIH_ECG
0923.jpg,432,288,N,1,273,261417,261690,MIT_BIH_ECG
0924.jpg,432,288,N,1,278,261690,261968,MIT_BIH_ECG
0925.jpg,432,288,N,1,273,261968,262241,MIT_BIH_ECG
0926.jpg,432,288,N,1,275,262241,262516,MIT_BIH_ECG
0927.jpg,432,288,N,1,273,262516,262789,MIT_BIH_ECG
0928.jpg,432,288,N,1,273,262789,263062,MIT_BIH_ECG
0929.jpg,432,288,N,1,288,263062,263350,MIT_BIH_ECG
0930.jpg,432,288,N,1,291,263350,263641,MIT_BIH_ECG
0931.jpg,432,288,N,1,290,263641,263931,MIT_BIH_ECG
0932.jpg,432,288,N,1,286,263931,264217,MIT_BIH_ECG
0933.jpg,432,288,N,1,282,264217,264499,MIT_BIH_ECG
0934.jpg,432,288,N,1,273,264499,264772,MIT_BIH_ECG
0935.jpg,432,288,N,1,290,264772,265062,MIT_BIH_ECG
0936.jpg,432,288,N,1,292,265062,265354,MIT_BIH_ECG
0937.jpg,432,288,N,1,297,265354,265651,MIT_BIH_ECG
0938.jpg,432,288,N,1,296,265651,265947,MIT_BIH_ECG
0939.jpg,432,288,N,1,291,265947,266238,MIT_BIH_ECG
0940.jpg,432,288,N,1,290,266238,266528,MIT_BIH_ECG
0941.jpg,432,288,N,1,287,266528,266815,MIT_BIH_ECG
0942.jpg,432,288,N,1,284,266815,267099,MIT_BIH_ECG
0943.jpg,432,288,N,1,276,267099,267375,MIT_BIH_ECG
0944.jpg,432,288,N,1,304,267375,267679,MIT_BIH_ECG
0945.jpg,432,288,N,1,299,267679,267978,MIT_BIH_ECG
0946.jpg,432,288,N,1,282,267978,268260,MIT_BIH_ECG
0947.jpg,432,288,N,1,284,268260,268544,MIT_BIH_ECG
0948.jpg,432,288,N,1,279,268544,268823,MIT_BIH_ECG
0949.jpg,432,288,N,1,279,268823,269102,MIT_BIH_ECG
0950.jpg,432,288,N,1,282,269102,269384,MIT_BIH_ECG
0951.jpg,432,288,N,1,285,269384,269669,MIT_BIH_ECG
0952.jpg,432,288,N,1,291,269669,269960,MIT_BIH_ECG
0953.jpg,432,288,N,1,297,269960,270257,MIT_BIH_ECG
0954.jpg,432,288,N,1,293,270257,270550,MIT_BIH_ECG
0955.jpg,432,288,N,1,271,270550,270821,MIT_BIH_ECG
0956.jpg,432,288,N,1,273,270821,271094,MIT_BIH_ECG
0957.jpg,432,288,N,1,276,271094,271370,MIT_BIH_ECG
0958.jpg,432,288,N,1,286,271370,271656,MIT_BIH_ECG
0959.jpg,432,288,N,1,296,271656,271952,MIT_BIH_ECG
0960.jpg,432,288,N,1,292,271952,272244,MIT_BIH_ECG
0961.jpg,432,288,N,1,289,272244,272533,MIT_BIH_ECG
0962.jpg,432,288,N,1,306,272533,272839,MIT_BIH_ECG
0963.jpg,432,288,N,1,284,272839,273123,MIT_BIH_ECG
0964.jpg,432,288,N,1,271,273123,273394,MIT_BIH_ECG
0965.jpg,432,288,N,1,281,273394,273675,MIT_BIH_ECG
0966.jpg,432,288,N,1,292,273675,273967,MIT_BIH_ECG
0967.jpg,432,288,N,1,297,273967,274264,MIT_BIH_ECG
0968.jpg,432,288,N,1,296,274264,274560,MIT_BIH_ECG
0969.jpg,432,288,N,1,292,274560,274852,MIT_BIH_ECG
0970.jpg,432,288,N,1,279,274852,275131,MIT_BIH_ECG
0971.jpg,432,288,N,1,272,275131,275403,MIT_BIH_ECG
0972.jpg,432,288,N,1,268,275403,275671,MIT_BIH_ECG
0973.jpg,432,288,N,1,278,275671,275949,MIT_BIH_ECG
0974.jpg,432,288,N,1,286,275949,276235,MIT_BIH_ECG
0975.jpg,432,288,N,1,281,276235,276516,MIT_BIH_ECG
0976.jpg,432,288,N,1,288,276516,276804,MIT_BIH_ECG
0977.jpg,432,288,N,1,298,276804,277102,MIT_BIH_ECG
0978.jpg,432,288,N,1,286,277102,277388,MIT_BIH_ECG
0979.jpg,432,288,N,1,261,277388,277649,MIT_BIH_ECG
0980.jpg,432,288,N,1,274,277649,277923,MIT_BIH_ECG
0981.jpg,432,288,N,1,288,277923,278211,MIT_BIH_ECG
0982.jpg,432,288,N,1,307,278211,278518,MIT_BIH_ECG
0983.jpg,432,288,N,1,296,278518,278814,MIT_BIH_ECG
0984.jpg,432,288,N,1,284,278814,279098,MIT_BIH_ECG
0985.jpg,432,288,N,1,284,279098,279382,MIT_BIH_ECG
0986.jpg,432,288,N,1,194,279382,279576,MIT_BIH_ECG
0987.jpg,432,288,A_A,0,342,279576,279918,MIT_BIH_ECG
0988.jpg,432,288,N,1,291,279918,280209,MIT_BIH_ECG
0989.jpg,432,288,N,1,302,280209,280511,MIT_BIH_ECG
0990.jpg,432,288,N,1,303,280511,280814,MIT_BIH_ECG
0991.jpg,432,288,N,1,296,280814,281110,MIT_BIH_ECG
0992.jpg,432,288,N,1,292,281110,281402,MIT_BIH_ECG
0993.jpg,432,288,N,1,280,281402,281682,MIT_BIH_ECG
0994.jpg,432,288,N,1,273,281682,281955,MIT_BIH_ECG
0995.jpg,432,288,N,1,277,281955,282232,MIT_BIH_ECG
0996.jpg,432,288,N,1,281,282232,282513,MIT_BIH_ECG
0997.jpg,432,288,N,1,288,282513,282801,MIT_BIH_ECG
0998.jpg,432,288,N,1,295,282801,283096,MIT_BIH_ECG
0999.jpg,432,288,N,1,293,283096,283389,MIT_BIH_ECG
1000.jpg,432,288,N,1,283,283389,283672,MIT_BIH_ECG
1001.jpg,432,288,N,1,272,283672,283944,MIT_BIH_ECG
1002.jpg,432,288,N,1,272,283944,284216,MIT_BIH_ECG
1003.jpg,432,288,N,1,275,284216,284491,MIT_BIH_ECG
1004.jpg,432,288,N,1,287,284491,284778,MIT_BIH_ECG
1005.jpg,432,288,N,1,295,284778,285073,MIT_BIH_ECG
1006.jpg,432,288,N,1,290,285073,285363,MIT_BIH_ECG
1007.jpg,432,288,N,1,290,285363,285653,MIT_BIH_ECG
1008.jpg,432,288,N,1,283,285653,285936,MIT_BIH_ECG
1009.jpg,432,288,N,1,274,285936,286210,MIT_BIH_ECG
1010.jpg,432,288,N,1,276,286210,286486,MIT_BIH_ECG
1011.jpg,432,288,N,1,277,286486,286763,MIT_BIH_ECG
1012.jpg,432,288,N,1,288,286763,287051,MIT_BIH_ECG
1013.jpg,432,288,N,1,302,287051,287353,MIT_BIH_ECG
1014.jpg,432,288,N,1,302,287353,287655,MIT_BIH_ECG
1015.jpg,432,288,N,1,289,287655,287944,MIT_BIH_ECG
1016.jpg,432,288,N,1,281,287944,288225,MIT_BIH_ECG
1017.jpg,432,288,N,1,281,288225,288506,MIT_BIH_ECG
1018.jpg,432,288,N,1,286,288506,288792,MIT_BIH_ECG
1019.jpg,432,288,N,1,284,288792,289076,MIT_BIH_ECG
1020.jpg,432,288,N,1,297,289076,289373,MIT_BIH_ECG
1021.jpg,432,288,N,1,294,289373,289667,MIT_BIH_ECG
1022.jpg,432,288,N,1,304,289667,289971,MIT_BIH_ECG
1023.jpg,432,288,N,1,286,289971,290257,MIT_BIH_ECG
1024.jpg,432,288,N,1,281,290257,290538,MIT_BIH_ECG
1025.jpg,432,288,N,1,275,290538,290813,MIT_BIH_ECG
1026.jpg,432,288,N,1,296,290813,291109,MIT_BIH_ECG
1027.jpg,432,288,N,1,298,291109,291407,MIT_BIH_ECG
1028.jpg,432,288,N,1,289,291407,291696,MIT_BIH_ECG
1029.jpg,432,288,N,1,294,291696,291990,MIT_BIH_ECG
1030.jpg,432,288,N,1,291,291990,292281,MIT_BIH_ECG
1031.jpg,432,288,N,1,285,292281,292566,MIT_BIH_ECG
1032.jpg,432,288,N,1,278,292566,292844,MIT_BIH_ECG
1033.jpg,432,288,N,1,279,292844,293123,MIT_BIH_ECG
1034.jpg,432,288,N,1,288,293123,293411,MIT_BIH_ECG
1035.jpg,432,288,N,1,301,293411,293712,MIT_BIH_ECG
1036.jpg,432,288,N,1,299,293712,294011,MIT_BIH_ECG
1037.jpg,432,288,N,1,285,294011,294296,MIT_BIH_ECG
1038.jpg,432,288,N,1,285,294296,294581,MIT_BIH_ECG
1039.jpg,432,288,N,1,276,294581,294857,MIT_BIH_ECG
1040.jpg,432,288,N,1,285,294857,295142,MIT_BIH_ECG
1041.jpg,432,288,N,1,279,295142,295421,MIT_BIH_ECG
1042.jpg,432,288,N,1,296,295421,295717,MIT_BIH_ECG
1043.jpg,432,288,N,1,296,295717,296013,MIT_BIH_ECG
1044.jpg,432,288,N,1,306,296013,296319,MIT_BIH_ECG
1045.jpg,432,288,N,1,292,296319,296611,MIT_BIH_ECG
1046.jpg,432,288,N,1,278,296611,296889,MIT_BIH_ECG
1047.jpg,432,288,N,1,280,296889,297169,MIT_BIH_ECG
1048.jpg,432,288,N,1,281,297169,297450,MIT_BIH_ECG
1049.jpg,432,288,N,1,288,297450,297738,MIT_BIH_ECG
1050.jpg,432,288,N,1,294,297738,298032,MIT_BIH_ECG
1051.jpg,432,288,N,1,302,298032,298334,MIT_BIH_ECG
1052.jpg,432,288,N,1,293,298334,298627,MIT_BIH_ECG
1053.jpg,432,288,N,1,293,298627,298920,MIT_BIH_ECG
1054.jpg,432,288,N,1,286,298920,299206,MIT_BIH_ECG
1055.jpg,432,288,N,1,277,299206,299483,MIT_BIH_ECG
1056.jpg,432,288,N,1,273,299483,299756,MIT_BIH_ECG
1057.jpg,432,288,N,1,295,299756,300051,MIT_BIH_ECG
1058.jpg,432,288,N,1,309,300051,300360,MIT_BIH_ECG
1059.jpg,432,288,N,1,302,300360,300662,MIT_BIH_ECG
1060.jpg,432,288,N,1,278,300662,300940,MIT_BIH_ECG
1061.jpg,432,288,N,1,270,300940,301210,MIT_BIH_ECG
1062.jpg,432,288,N,1,284,301210,301494,MIT_BIH_ECG
1063.jpg,432,288,N,1,287,301494,301781,MIT_BIH_ECG
1064.jpg,432,288,N,1,282,301781,302063,MIT_BIH_ECG
1065.jpg,432,288,N,1,284,302063,302347,MIT_BIH_ECG
1066.jpg,432,288,N,1,297,302347,302644,MIT_BIH_ECG
1067.jpg,432,288,N,1,303,302644,302947,MIT_BIH_ECG
1068.jpg,432,288,N,1,293,302947,303240,MIT_BIH_ECG
1069.jpg,432,288,N,1,263,303240,303503,MIT_BIH_ECG
1070.jpg,432,288,N,1,270,303503,303773,MIT_BIH_ECG
1071.jpg,432,288,N,1,292,303773,304065,MIT_BIH_ECG
1072.jpg,432,288,N,1,296,304065,304361,MIT_BIH_ECG
1073.jpg,432,288,N,1,278,304361,304639,MIT_BIH_ECG
1074.jpg,432,288,N,1,284,304639,304923,MIT_BIH_ECG
1075.jpg,432,288,N,1,288,304923,305211,MIT_BIH_ECG
1076.jpg,432,288,N,1,286,305211,305497,MIT_BIH_ECG
1077.jpg,432,288,N,1,212,305497,305709,MIT_BIH_ECG
1078.jpg,432,288,A_A,0,326,305709,306035,MIT_BIH_ECG
1079.jpg,432,288,N,1,302,306035,306337,MIT_BIH_ECG
1080.jpg,432,288,N,1,304,306337,306641,MIT_BIH_ECG
1081.jpg,432,288,N,1,302,306641,306943,MIT_BIH_ECG
1082.jpg,432,288,N,1,291,306943,307234,MIT_BIH_ECG
1083.jpg,432,288,N,1,280,307234,307514,MIT_BIH_ECG
1084.jpg,432,288,N,1,231,307514,307745,MIT_BIH_ECG
1085.jpg,432,288,A_A,0,317,307745,308062,MIT_BIH_ECG
1086.jpg,432,288,N,1,287,308062,308349,MIT_BIH_ECG
1087.jpg,432,288,N,1,276,308349,308625,MIT_BIH_ECG
1088.jpg,432,288,N,1,287,308625,308912,MIT_BIH_ECG
1089.jpg,432,288,N,1,304,308912,309216,MIT_BIH_ECG
1090.jpg,432,288,N,1,299,309216,309515,MIT_BIH_ECG
1091.jpg,432,288,N,1,265,309515,309780,MIT_BIH_ECG
1092.jpg,432,288,N,1,272,309780,310052,MIT_BIH_ECG
1093.jpg,432,288,N,1,280,310052,310332,MIT_BIH_ECG
1094.jpg,432,288,N,1,294,310332,310626,MIT_BIH_ECG
1095.jpg,432,288,N,1,288,310626,310914,MIT_BIH_ECG
1096.jpg,432,288,N,1,285,310914,311199,MIT_BIH_ECG
1097.jpg,432,288,N,1,289,311199,311488,MIT_BIH_ECG
1098.jpg,432,288,N,1,295,311488,311783,MIT_BIH_ECG
1099.jpg,432,288,N,1,279,311783,312062,MIT_BIH_ECG
1100.jpg,432,288,N,1,265,312062,312327,MIT_BIH_ECG
1101.jpg,432,288,N,1,278,312327,312605,MIT_BIH_ECG
1102.jpg,432,288,N,1,220,312605,312825,MIT_BIH_ECG
1103.jpg,432,288,A_A,0,368,312825,313193,MIT_BIH_ECG
1104.jpg,432,288,N,1,315,313193,313508,MIT_BIH_ECG
1105.jpg,432,288,N,1,300,313508,313808,MIT_BIH_ECG
1106.jpg,432,288,N,1,282,313808,314090,MIT_BIH_ECG
1107.jpg,432,288,N,1,283,314090,314373,MIT_BIH_ECG
1108.jpg,432,288,N,1,291,314373,314664,MIT_BIH_ECG
1109.jpg,432,288,N,1,288,314664,314952,MIT_BIH_ECG
1110.jpg,432,288,N,1,293,314952,315245,MIT_BIH_ECG
1111.jpg,432,288,N,1,296,315245,315541,MIT_BIH_ECG
1112.jpg,432,288,N,1,302,315541,315843,MIT_BIH_ECG
1113.jpg,432,288,N,1,293,315843,316136,MIT_BIH_ECG
1114.jpg,432,288,N,1,279,316136,316415,MIT_BIH_ECG
1115.jpg,432,288,N,1,278,316415,316693,MIT_BIH_ECG
1116.jpg,432,288,N,1,287,316693,316980,MIT_BIH_ECG
1117.jpg,432,288,N,1,286,316980,317266,MIT_BIH_ECG
1118.jpg,432,288,N,1,294,317266,317560,MIT_BIH_ECG
1119.jpg,432,288,N,1,225,317560,317785,MIT_BIH_ECG
1120.jpg,432,288,A_A,0,360,317785,318145,MIT_BIH_ECG
1121.jpg,432,288,N,1,293,318145,318438,MIT_BIH_ECG
1122.jpg,432,288,N,1,291,318438,318729,MIT_BIH_ECG
1123.jpg,432,288,N,1,282,318729,319011,MIT_BIH_ECG
1124.jpg,432,288,N,1,212,319011,319223,MIT_BIH_ECG
1125.jpg,432,288,A_A,0,363,319223,319586,MIT_BIH_ECG
1126.jpg,432,288,N,1,318,319586,319904,MIT_BIH_ECG
1127.jpg,432,288,N,1,301,319904,320205,MIT_BIH_ECG
1128.jpg,432,288,N,1,288,320205,320493,MIT_BIH_ECG
1129.jpg,432,288,N,1,293,320493,320786,MIT_BIH_ECG
1130.jpg,432,288,N,1,286,320786,321072,MIT_BIH_ECG
1131.jpg,432,288,N,1,299,321072,321371,MIT_BIH_ECG
1132.jpg,432,288,N,1,292,321371,321663,MIT_BIH_ECG
1133.jpg,432,288,N,1,305,321663,321968,MIT_BIH_ECG
1134.jpg,432,288,N,1,307,321968,322275,MIT_BIH_ECG
1135.jpg,432,288,N,1,298,322275,322573,MIT_BIH_ECG
1136.jpg,432,288,N,1,283,322573,322856,MIT_BIH_ECG
1137.jpg,432,288,N,1,282,322856,323138,MIT_BIH_ECG
1138.jpg,432,288,N,1,287,323138,323425,MIT_BIH_ECG
1139.jpg,432,288,N,1,305,323425,323730,MIT_BIH_ECG
1140.jpg,432,288,N,1,314,323730,324044,MIT_BIH_ECG
1141.jpg,432,288,N,1,296,324044,324340,MIT_BIH_ECG
1142.jpg,432,288,N,1,301,324340,324641,MIT_BIH_ECG
1143.jpg,432,288,N,1,288,324641,324929,MIT_BIH_ECG
1144.jpg,432,288,N,1,286,324929,325215,MIT_BIH_ECG
1145.jpg,432,288,N,1,280,325215,325495,MIT_BIH_ECG
1146.jpg,432,288,N,1,287,325495,325782,MIT_BIH_ECG
1147.jpg,432,288,N,1,306,325782,326088,MIT_BIH_ECG
1148.jpg,432,288,N,1,307,326088,326395,MIT_BIH_ECG
1149.jpg,432,288,N,1,303,326395,326698,MIT_BIH_ECG
1150.jpg,432,288,N,1,288,326698,326986,MIT_BIH_ECG
1151.jpg,432,288,N,1,290,326986,327276,MIT_BIH_ECG
1152.jpg,432,288,N,1,290,327276,327566,MIT_BIH_ECG
1153.jpg,432,288,N,1,292,327566,327858,MIT_BIH_ECG
1154.jpg,432,288,N,1,291,327858,328149,MIT_BIH_ECG
1155.jpg,432,288,N,1,303,328149,328452,MIT_BIH_ECG
1156.jpg,432,288,N,1,301,328452,328753,MIT_BIH_ECG
1157.jpg,432,288,N,1,303,328753,329056,MIT_BIH_ECG
1158.jpg,432,288,N,1,283,329056,329339,MIT_BIH_ECG
1159.jpg,432,288,N,1,280,329339,329619,MIT_BIH_ECG
1160.jpg,432,288,N,1,293,329619,329912,MIT_BIH_ECG
1161.jpg,432,288,N,1,304,329912,330216,MIT_BIH_ECG
1162.jpg,432,288,N,1,308,330216,330524,MIT_BIH_ECG
1163.jpg,432,288,N,1,295,330524,330819,MIT_BIH_ECG
1164.jpg,432,288,N,1,305,330819,331124,MIT_BIH_ECG
1165.jpg,432,288,N,1,287,331124,331411,MIT_BIH_ECG
1166.jpg,432,288,N,1,293,331411,331704,MIT_BIH_ECG
1167.jpg,432,288,N,1,285,331704,331989,MIT_BIH_ECG
1168.jpg,432,288,N,1,290,331989,332279,MIT_BIH_ECG
1169.jpg,432,288,N,1,309,332279,332588,MIT_BIH_ECG
1170.jpg,432,288,N,1,309,332588,332897,MIT_BIH_ECG
1171.jpg,432,288,N,1,302,332897,333199,MIT_BIH_ECG
1172.jpg,432,288,N,1,280,333199,333479,MIT_BIH_ECG
1173.jpg,432,288,N,1,289,333479,333768,MIT_BIH_ECG
1174.jpg,432,288,N,1,288,333768,334056,MIT_BIH_ECG
1175.jpg,432,288,N,1,292,334056,334348,MIT_BIH_ECG
1176.jpg,432,288,N,1,295,334348,334643,MIT_BIH_ECG
1177.jpg,432,288,N,1,300,334643,334943,MIT_BIH_ECG
1178.jpg,432,288,N,1,305,334943,335248,MIT_BIH_ECG
1179.jpg,432,288,N,1,295,335248,335543,MIT_BIH_ECG
1180.jpg,432,288,N,1,280,335543,335823,MIT_BIH_ECG
1181.jpg,432,288,N,1,277,335823,336100,MIT_BIH_ECG
1182.jpg,432,288,N,1,285,336100,336385,MIT_BIH_ECG
1183.jpg,432,288,N,1,294,336385,336679,MIT_BIH_ECG
1184.jpg,432,288,N,1,300,336679,336979,MIT_BIH_ECG
1185.jpg,432,288,N,1,302,336979,337281,MIT_BIH_ECG
1186.jpg,432,288,N,1,290,337281,337571,MIT_BIH_ECG
1187.jpg,432,288,N,1,291,337571,337862,MIT_BIH_ECG
1188.jpg,432,288,N,1,283,337862,338145,MIT_BIH_ECG
1189.jpg,432,288,N,1,287,338145,338432,MIT_BIH_ECG
1190.jpg,432,288,N,1,288,338432,338720,MIT_BIH_ECG
1191.jpg,432,288,N,1,305,338720,339025,MIT_BIH_ECG
1192.jpg,432,288,N,1,302,339025,339327,MIT_BIH_ECG
1193.jpg,432,288,N,1,307,339327,339634,MIT_BIH_ECG
1194.jpg,432,288,N,1,292,339634,339926,MIT_BIH_ECG
1195.jpg,432,288,N,1,279,339926,340205,MIT_BIH_ECG
1196.jpg,432,288,N,1,287,340205,340492,MIT_BIH_ECG
1197.jpg,432,288,N,1,288,340492,340780,MIT_BIH_ECG
1198.jpg,432,288,N,1,295,340780,341075,MIT_BIH_ECG
1199.jpg,432,288,N,1,304,341075,341379,MIT_BIH_ECG
1200.jpg,432,288,N,1,305,341379,341684,MIT_BIH_ECG
1201.jpg,432,288,N,1,290,341684,341974,MIT_BIH_ECG
1202.jpg,432,288,N,1,292,341974,342266,MIT_BIH_ECG
1203.jpg,432,288,N,1,281,342266,342547,MIT_BIH_ECG
1204.jpg,432,288,N,1,275,342547,342822,MIT_BIH_ECG
1205.jpg,432,288,N,1,293,342822,343115,MIT_BIH_ECG
1206.jpg,432,288,N,1,294,343115,343409,MIT_BIH_ECG
1207.jpg,432,288,N,1,296,343409,343705,MIT_BIH_ECG
1208.jpg,432,288,N,1,290,343705,343995,MIT_BIH_ECG
1209.jpg,432,288,N,1,284,343995,344279,MIT_BIH_ECG
1210.jpg,432,288,N,1,277,344279,344556,MIT_BIH_ECG
1211.jpg,432,288,N,1,287,344556,344843,MIT_BIH_ECG
1212.jpg,432,288,N,1,286,344843,345129,MIT_BIH_ECG
1213.jpg,432,288,N,1,286,345129,345415,MIT_BIH_ECG
1214.jpg,432,288,N,1,307,345415,345722,MIT_BIH_ECG
1215.jpg,432,288,N,1,295,345722,346017,MIT_BIH_ECG
1216.jpg,432,288,N,1,291,346017,346308,MIT_BIH_ECG
1217.jpg,432,288,N,1,288,346308,346596,MIT_BIH_ECG
1218.jpg,432,288,N,1,208,346596,346804,MIT_BIH_ECG
1219.jpg,432,288,A_A,0,343,346804,347147,MIT_BIH_ECG
1220.jpg,432,288,N,1,307,347147,347454,MIT_BIH_ECG
1221.jpg,432,288,N,1,305,347454,347759,MIT_BIH_ECG
1222.jpg,432,288,N,1,304,347759,348063,MIT_BIH_ECG
1223.jpg,432,288,N,1,304,348063,348367,MIT_BIH_ECG
1224.jpg,432,288,N,1,291,348367,348658,MIT_BIH_ECG
1225.jpg,432,288,N,1,276,348658,348934,MIT_BIH_ECG
1226.jpg,432,288,N,1,287,348934,349221,MIT_BIH_ECG
1227.jpg,432,288,N,1,281,349221,349502,MIT_BIH_ECG
1228.jpg,432,288,N,1,302,349502,349804,MIT_BIH_ECG
1229.jpg,432,288,N,1,308,349804,350112,MIT_BIH_ECG
1230.jpg,432,288,N,1,298,350112,350410,MIT_BIH_ECG
1231.jpg,432,288,N,1,282,350410,350692,MIT_BIH_ECG
1232.jpg,432,288,N,1,288,350692,350980,MIT_BIH_ECG
1233.jpg,432,288,N,1,285,350980,351265,MIT_BIH_ECG
1234.jpg,432,288,N,1,216,351265,351481,MIT_BIH_ECG
1235.jpg,432,288,A_A,0,340,351481,351821,MIT_BIH_ECG
1236.jpg,432,288,N,1,294,351821,352115,MIT_BIH_ECG
1237.jpg,432,288,N,1,301,352115,352416,MIT_BIH_ECG
1238.jpg,432,288,N,1,295,352416,352711,MIT_BIH_ECG
1239.jpg,432,288,N,1,275,352711,352986,MIT_BIH_ECG
1240.jpg,432,288,N,1,271,352986,353257,MIT_BIH_ECG
1241.jpg,432,288,N,1,290,353257,353547,MIT_BIH_ECG
1242.jpg,432,288,N,1,285,353547,353832,MIT_BIH_ECG
1243.jpg,432,288,N,1,296,353832,354128,MIT_BIH_ECG
1244.jpg,432,288,N,1,298,354128,354426,MIT_BIH_ECG
1245.jpg,432,288,N,1,291,354426,354717,MIT_BIH_ECG
1246.jpg,432,288,N,1,298,354717,355015,MIT_BIH_ECG
1247.jpg,432,288,N,1,287,355015,355302,MIT_BIH_ECG
1248.jpg,432,288,N,1,277,355302,355579,MIT_BIH_ECG
1249.jpg,432,288,N,1,279,355579,355858,MIT_BIH_ECG
1250.jpg,432,288,N,1,307,355858,356165,MIT_BIH_ECG
1251.jpg,432,288,N,1,298,356165,356463,MIT_BIH_ECG
1252.jpg,432,288,N,1,295,356463,356758,MIT_BIH_ECG
1253.jpg,432,288,N,1,287,356758,357045,MIT_BIH_ECG
1254.jpg,432,288,N,1,282,357045,357327,MIT_BIH_ECG
1255.jpg,432,288,N,1,283,357327,357610,MIT_BIH_ECG
1256.jpg,432,288,N,1,290,357610,357900,MIT_BIH_ECG
1257.jpg,432,288,N,1,286,357900,358186,MIT_BIH_ECG
1258.jpg,432,288,N,1,296,358186,358482,MIT_BIH_ECG
1259.jpg,432,288,N,1,306,358482,358788,MIT_BIH_ECG
1260.jpg,432,288,N,1,298,358788,359086,MIT_BIH_ECG
1261.jpg,432,288,N,1,279,359086,359365,MIT_BIH_ECG
1262.jpg,432,288,N,1,269,359365,359634,MIT_BIH_ECG
1263.jpg,432,288,N,1,269,359634,359903,MIT_BIH_ECG
1264.jpg,432,288,N,1,279,359903,360182,MIT_BIH_ECG
1265.jpg,432,288,N,1,289,360182,360471,MIT_BIH_ECG
1266.jpg,432,288,N,1,292,360471,360763,MIT_BIH_ECG
1267.jpg,432,288,N,1,288,360763,361051,MIT_BIH_ECG
1268.jpg,432,288,N,1,292,361051,361343,MIT_BIH_ECG
1269.jpg,432,288,N,1,282,361343,361625,MIT_BIH_ECG
1270.jpg,432,288,N,1,269,361625,361894,MIT_BIH_ECG
1271.jpg,432,288,N,1,268,361894,362162,MIT_BIH_ECG
1272.jpg,432,288,N,1,289,362162,362451,MIT_BIH_ECG
1273.jpg,432,288,N,1,281,362451,362732,MIT_BIH_ECG
1274.jpg,432,288,N,1,294,362732,363026,MIT_BIH_ECG
1275.jpg,432,288,N,1,292,363026,363318,MIT_BIH_ECG
1276.jpg,432,288,N,1,288,363318,363606,MIT_BIH_ECG
1277.jpg,432,288,N,1,272,363606,363878,MIT_BIH_ECG
1278.jpg,432,288,N,1,280,363878,364158,MIT_BIH_ECG
1279.jpg,432,288,N,1,288,364158,364446,MIT_BIH_ECG
1280.jpg,432,288,N,1,284,364446,364730,MIT_BIH_ECG
1281.jpg,432,288,N,1,292,364730,365022,MIT_BIH_ECG
1282.jpg,432,288,N,1,308,365022,365330,MIT_BIH_ECG
1283.jpg,432,288,N,1,310,365330,365640,MIT_BIH_ECG
1284.jpg,432,288,N,1,274,365640,365914,MIT_BIH_ECG
1285.jpg,432,288,N,1,277,365914,366191,MIT_BIH_ECG
1286.jpg,432,288,N,1,291,366191,366482,MIT_BIH_ECG
1287.jpg,432,288,N,1,296,366482,366778,MIT_BIH_ECG
1288.jpg,432,288,N,1,285,366778,367063,MIT_BIH_ECG
1289.jpg,432,288,N,1,300,367063,367363,MIT_BIH_ECG
1290.jpg,432,288,N,1,311,367363,367674,MIT_BIH_ECG
1291.jpg,432,288,N,1,286,367674,367960,MIT_BIH_ECG
1292.jpg,432,288,N,1,287,367960,368247,MIT_BIH_ECG
1293.jpg,432,288,N,1,284,368247,368531,MIT_BIH_ECG
1294.jpg,432,288,N,1,293,368531,368824,MIT_BIH_ECG
1295.jpg,432,288,N,1,285,368824,369109,MIT_BIH_ECG
1296.jpg,432,288,N,1,301,369109,369410,MIT_BIH_ECG
1297.jpg,432,288,N,1,304,369410,369714,MIT_BIH_ECG
1298.jpg,432,288,N,1,296,369714,370010,MIT_BIH_ECG
1299.jpg,432,288,N,1,269,370010,370279,MIT_BIH_ECG
1300.jpg,432,288,N,1,278,370279,370557,MIT_BIH_ECG
1301.jpg,432,288,N,1,285,370557,370842,MIT_BIH_ECG
1302.jpg,432,288,N,1,289,370842,371131,MIT_BIH_ECG
1303.jpg,432,288,N,1,275,371131,371406,MIT_BIH_ECG
1304.jpg,432,288,N,1,297,371406,371703,MIT_BIH_ECG
1305.jpg,432,288,N,1,304,371703,372007,MIT_BIH_ECG
1306.jpg,432,288,N,1,292,372007,372299,MIT_BIH_ECG
1307.jpg,432,288,N,1,258,372299,372557,MIT_BIH_ECG
1308.jpg,432,288,N,1,277,372557,372834,MIT_BIH_ECG
1309.jpg,432,288,N,1,289,372834,373123,MIT_BIH_ECG
1310.jpg,432,288,N,1,305,373123,373428,MIT_BIH_ECG
1311.jpg,432,288,N,1,284,373428,373712,MIT_BIH_ECG
1312.jpg,432,288,N,1,288,373712,374000,MIT_BIH_ECG
1313.jpg,432,288,N,1,303,374000,374303,MIT_BIH_ECG
1314.jpg,432,288,N,1,292,374303,374595,MIT_BIH_ECG
1315.jpg,432,288,N,1,260,374595,374855,MIT_BIH_ECG
1316.jpg,432,288,N,1,269,374855,375124,MIT_BIH_ECG
1317.jpg,432,288,N,1,288,375124,375412,MIT_BIH_ECG
1318.jpg,432,288,N,1,303,375412,375715,MIT_BIH_ECG
1319.jpg,432,288,N,1,283,375715,375998,MIT_BIH_ECG
1320.jpg,432,288,N,1,289,375998,376287,MIT_BIH_ECG
1321.jpg,432,288,N,1,289,376287,376576,MIT_BIH_ECG
1322.jpg,432,288,N,1,285,376576,376861,MIT_BIH_ECG
1323.jpg,432,288,N,1,220,376861,377081,MIT_BIH_ECG
1324.jpg,432,288,A_A,0,323,377081,377404,MIT_BIH_ECG
1325.jpg,432,288,N,1,296,377404,377700,MIT_BIH_ECG
1326.jpg,432,288,N,1,305,377700,378005,MIT_BIH_ECG
1327.jpg,432,288,N,1,303,378005,378308,MIT_BIH_ECG
1328.jpg,432,288,N,1,300,378308,378608,MIT_BIH_ECG
1329.jpg,432,288,N,1,278,378608,378886,MIT_BIH_ECG
1330.jpg,432,288,N,1,273,378886,379159,MIT_BIH_ECG
1331.jpg,432,288,N,1,280,379159,379439,MIT_BIH_ECG
1332.jpg,432,288,N,1,292,379439,379731,MIT_BIH_ECG
1333.jpg,432,288,N,1,292,379731,380023,MIT_BIH_ECG
1334.jpg,432,288,N,1,289,380023,380312,MIT_BIH_ECG
1335.jpg,432,288,N,1,298,380312,380610,MIT_BIH_ECG
1336.jpg,432,288,N,1,288,380610,380898,MIT_BIH_ECG
1337.jpg,432,288,N,1,275,380898,381173,MIT_BIH_ECG
1338.jpg,432,288,N,1,279,381173,381452,MIT_BIH_ECG
1339.jpg,432,288,N,1,272,381452,381724,MIT_BIH_ECG
1340.jpg,432,288,N,1,290,381724,382014,MIT_BIH_ECG
1341.jpg,432,288,N,1,294,382014,382308,MIT_BIH_ECG
1342.jpg,432,288,N,1,299,382308,382607,MIT_BIH_ECG
1343.jpg,432,288,N,1,288,382607,382895,MIT_BIH_ECG
1344.jpg,432,288,N,1,288,382895,383183,MIT_BIH_ECG
1345.jpg,432,288,N,1,274,383183,383457,MIT_BIH_ECG
1346.jpg,432,288,N,1,286,383457,383743,MIT_BIH_ECG
1347.jpg,432,288,N,1,284,383743,384027,MIT_BIH_ECG
1348.jpg,432,288,N,1,290,384027,384317,MIT_BIH_ECG
1349.jpg,432,288,N,1,297,384317,384614,MIT_BIH_ECG
1350.jpg,432,288,N,1,301,384614,384915,MIT_BIH_ECG
1351.jpg,432,288,N,1,290,384915,385205,MIT_BIH_ECG
1352.jpg,432,288,N,1,282,385205,385487,MIT_BIH_ECG
1353.jpg,432,288,N,1,281,385487,385768,MIT_BIH_ECG
1354.jpg,432,288,N,1,282,385768,386050,MIT_BIH_ECG
1355.jpg,432,288,N,1,299,386050,386349,MIT_BIH_ECG
1356.jpg,432,288,N,1,300,386349,386649,MIT_BIH_ECG
1357.jpg,432,288,N,1,292,386649,386941,MIT_BIH_ECG
1358.jpg,432,288,N,1,300,386941,387241,MIT_BIH_ECG
1359.jpg,432,288,N,1,292,387241,387533,MIT_BIH_ECG
1360.jpg,432,288,N,1,278,387533,387811,MIT_BIH_ECG
1361.jpg,432,288,N,1,273,387811,388084,MIT_BIH_ECG
1362.jpg,432,288,N,1,289,388084,388373,MIT_BIH_ECG
1363.jpg,432,288,N,1,298,388373,388671,MIT_BIH_ECG
1364.jpg,432,288,N,1,308,388671,388979,MIT_BIH_ECG
1365.jpg,432,288,N,1,298,388979,389277,MIT_BIH_ECG
1366.jpg,432,288,N,1,286,389277,389563,MIT_BIH_ECG
1367.jpg,432,288,N,1,297,389563,389860,MIT_BIH_ECG
1368.jpg,432,288,N,1,289,389860,390149,MIT_BIH_ECG
1369.jpg,432,288,N,1,285,390149,390434,MIT_BIH_ECG
1370.jpg,432,288,N,1,296,390434,390730,MIT_BIH_ECG
1371.jpg,432,288,N,1,309,390730,391039,MIT_BIH_ECG
1372.jpg,432,288,N,1,305,391039,391344,MIT_BIH_ECG
1373.jpg,432,288,N,1,297,391344,391641,MIT_BIH_ECG
1374.jpg,432,288,N,1,283,391641,391924,MIT_BIH_ECG
1375.jpg,432,288,N,1,280,391924,392204,MIT_BIH_ECG
1376.jpg,432,288,N,1,289,392204,392493,MIT_BIH_ECG
1377.jpg,432,288,N,1,287,392493,392780,MIT_BIH_ECG
1378.jpg,432,288,N,1,297,392780,393077,MIT_BIH_ECG
1379.jpg,432,288,N,1,300,393077,393377,MIT_BIH_ECG
1380.jpg,432,288,N,1,297,393377,393674,MIT_BIH_ECG
1381.jpg,432,288,N,1,283,393674,393957,MIT_BIH_ECG
1382.jpg,432,288,N,1,286,393957,394243,MIT_BIH_ECG
1383.jpg,432,288,N,1,276,394243,394519,MIT_BIH_ECG
1384.jpg,432,288,N,1,282,394519,394801,MIT_BIH_ECG
1385.jpg,432,288,N,1,295,394801,395096,MIT_BIH_ECG
1386.jpg,432,288,N,1,305,395096,395401,MIT_BIH_ECG
1387.jpg,432,288,N,1,296,395401,395697,MIT_BIH_ECG
1388.jpg,432,288,N,1,292,395697,395989,MIT_BIH_ECG
1389.jpg,432,288,N,1,279,395989,396268,MIT_BIH_ECG
1390.jpg,432,288,N,1,285,396268,396553,MIT_BIH_ECG
1391.jpg,432,288,N,1,292,396553,396845,MIT_BIH_ECG
1392.jpg,432,288,N,1,288,396845,397133,MIT_BIH_ECG
1393.jpg,432,288,N,1,202,397133,397335,MIT_BIH_ECG
1394.jpg,432,288,A_A,0,369,397335,397704,MIT_BIH_ECG
1395.jpg,432,288,N,1,303,397704,398007,MIT_BIH_ECG
1396.jpg,432,288,N,1,287,398007,398294,MIT_BIH_ECG
1397.jpg,432,288,N,1,275,398294,398569,MIT_BIH_ECG
1398.jpg,432,288,N,1,284,398569,398853,MIT_BIH_ECG
1399.jpg,432,288,N,1,286,398853,399139,MIT_BIH_ECG
1400.jpg,432,288,N,1,297,399139,399436,MIT_BIH_ECG
1401.jpg,432,288,N,1,294,399436,399730,MIT_BIH_ECG
1402.jpg,432,288,N,1,293,399730,400023,MIT_BIH_ECG
1403.jpg,432,288,N,1,298,400023,400321,MIT_BIH_ECG
1404.jpg,432,288,N,1,278,400321,400599,MIT_BIH_ECG
1405.jpg,432,288,N,1,278,400599,400877,MIT_BIH_ECG
1406.jpg,432,288,N,1,286,400877,401163,MIT_BIH_ECG
1407.jpg,432,288,N,1,290,401163,401453,MIT_BIH_ECG
1408.jpg,432,288,N,1,304,401453,401757,MIT_BIH_ECG
1409.jpg,432,288,N,1,304,401757,402061,MIT_BIH_ECG
1410.jpg,432,288,N,1,300,402061,402361,MIT_BIH_ECG
1411.jpg,432,288,N,1,285,402361,402646,MIT_BIH_ECG
1412.jpg,432,288,N,1,287,402646,402933,MIT_BIH_ECG
1413.jpg,432,288,N,1,282,402933,403215,MIT_BIH_ECG
1414.jpg,432,288,N,1,294,403215,403509,MIT_BIH_ECG
1415.jpg,432,288,N,1,295,403509,403804,MIT_BIH_ECG
1416.jpg,432,288,N,1,296,403804,404100,MIT_BIH_ECG
1417.jpg,432,288,N,1,303,404100,404403,MIT_BIH_ECG
1418.jpg,432,288,N,1,294,404403,404697,MIT_BIH_ECG
1419.jpg,432,288,N,1,283,404697,404980,MIT_BIH_ECG
1420.jpg,432,288,N,1,275,404980,405255,MIT_BIH_ECG
1421.jpg,432,288,N,1,288,405255,405543,MIT_BIH_ECG
1422.jpg,432,288,N,1,293,405543,405836,MIT_BIH_ECG
1423.jpg,432,288,N,1,295,405836,406131,MIT_BIH_ECG
1424.jpg,432,288,N,1,294,406131,406425,MIT_BIH_ECG
1425.jpg,432,288,N,1,290,406425,406715,MIT_BIH_ECG
1426.jpg,432,288,N,1,290,406715,407005,MIT_BIH_ECG
1427.jpg,432,288,N,1,283,407005,407288,MIT_BIH_ECG
1428.jpg,432,288,N,1,271,407288,407559,MIT_BIH_ECG
1429.jpg,432,288,N,1,290,407559,407849,MIT_BIH_ECG
1430.jpg,432,288,N,1,302,407849,408151,MIT_BIH_ECG
1431.jpg,432,288,N,1,301,408151,408452,MIT_BIH_ECG
1432.jpg,432,288,N,1,294,408452,408746,MIT_BIH_ECG
1433.jpg,432,288,N,1,284,408746,409030,MIT_BIH_ECG
1434.jpg,432,288,N,1,284,409030,409314,MIT_BIH_ECG
1435.jpg,432,288,N,1,283,409314,409597,MIT_BIH_ECG
1436.jpg,432,288,N,1,284,409597,409881,MIT_BIH_ECG
1437.jpg,432,288,N,1,296,409881,410177,MIT_BIH_ECG
1438.jpg,432,288,N,1,300,410177,410477,MIT_BIH_ECG
1439.jpg,432,288,N,1,304,410477,410781,MIT_BIH_ECG
1440.jpg,432,288,N,1,290,410781,411071,MIT_BIH_ECG
1441.jpg,432,288,N,1,281,411071,411352,MIT_BIH_ECG
1442.jpg,432,288,N,1,280,411352,411632,MIT_BIH_ECG
1443.jpg,432,288,N,1,283,411632,411915,MIT_BIH_ECG
1444.jpg,432,288,N,1,291,411915,412206,MIT_BIH_ECG
1445.jpg,432,288,N,1,306,412206,412512,MIT_BIH_ECG
1446.jpg,432,288,N,1,304,412512,412816,MIT_BIH_ECG
1447.jpg,432,288,N,1,293,412816,413109,MIT_BIH_ECG
1448.jpg,432,288,N,1,293,413109,413402,MIT_BIH_ECG
1449.jpg,432,288,N,1,290,413402,413692,MIT_BIH_ECG
1450.jpg,432,288,N,1,277,413692,413969,MIT_BIH_ECG
1451.jpg,432,288,N,1,280,413969,414249,MIT_BIH_ECG
1452.jpg,432,288,N,1,292,414249,414541,MIT_BIH_ECG
1453.jpg,432,288,N,1,306,414541,414847,MIT_BIH_ECG
1454.jpg,432,288,N,1,296,414847,415143,MIT_BIH_ECG
1455.jpg,432,288,N,1,287,415143,415430,MIT_BIH_ECG
1456.jpg,432,288,N,1,273,415430,415703,MIT_BIH_ECG
1457.jpg,432,288,N,1,291,415703,415994,MIT_BIH_ECG
1458.jpg,432,288,N,1,281,415994,416275,MIT_BIH_ECG
1459.jpg,432,288,N,1,280,416275,416555,MIT_BIH_ECG
1460.jpg,432,288,N,1,294,416555,416849,MIT_BIH_ECG
1461.jpg,432,288,N,1,303,416849,417152,MIT_BIH_ECG
1462.jpg,432,288,N,1,293,417152,417445,MIT_BIH_ECG
1463.jpg,432,288,N,1,283,417445,417728,MIT_BIH_ECG
1464.jpg,432,288,N,1,278,417728,418006,MIT_BIH_ECG
1465.jpg,432,288,N,1,277,418006,418283,MIT_BIH_ECG
1466.jpg,432,288,N,1,294,418283,418577,MIT_BIH_ECG
1467.jpg,432,288,N,1,289,418577,418866,MIT_BIH_ECG
1468.jpg,432,288,N,1,289,418866,419155,MIT_BIH_ECG
1469.jpg,432,288,N,1,298,419155,419453,MIT_BIH_ECG
1470.jpg,432,288,N,1,292,419453,419745,MIT_BIH_ECG
1471.jpg,432,288,N,1,277,419745,420022,MIT_BIH_ECG
1472.jpg,432,288,N,1,280,420022,420302,MIT_BIH_ECG
1473.jpg,432,288,N,1,281,420302,420583,MIT_BIH_ECG
1474.jpg,432,288,N,1,290,420583,420873,MIT_BIH_ECG
1475.jpg,432,288,N,1,300,420873,421173,MIT_BIH_ECG
1476.jpg,432,288,N,1,301,421173,421474,MIT_BIH_ECG
1477.jpg,432,288,N,1,292,421474,421766,MIT_BIH_ECG
1478.jpg,432,288,N,1,228,421766,421994,MIT_BIH_ECG
1479.jpg,432,288,A_A,0,326,421994,422320,MIT_BIH_ECG
1480.jpg,432,288,N,1,283,422320,422603,MIT_BIH_ECG
1481.jpg,432,288,N,1,215,422603,422818,MIT_BIH_ECG
1482.jpg,432,288,A_A,0,346,422818,423164,MIT_BIH_ECG
1483.jpg,432,288,N,1,298,423164,423462,MIT_BIH_ECG
1484.jpg,432,288,N,1,305,423462,423767,MIT_BIH_ECG
1485.jpg,432,288,N,1,297,423767,424064,MIT_BIH_ECG
1486.jpg,432,288,N,1,275,424064,424339,MIT_BIH_ECG
1487.jpg,432,288,N,1,277,424339,424616,MIT_BIH_ECG
1488.jpg,432,288,N,1,277,424616,424893,MIT_BIH_ECG
1489.jpg,432,288,N,1,295,424893,425188,MIT_BIH_ECG
1490.jpg,432,288,N,1,303,425188,425491,MIT_BIH_ECG
1491.jpg,432,288,N,1,297,425491,425788,MIT_BIH_ECG
1492.jpg,432,288,N,1,290,425788,426078,MIT_BIH_ECG
1493.jpg,432,288,N,1,302,426078,426380,MIT_BIH_ECG
1494.jpg,432,288,N,1,281,426380,426661,MIT_BIH_ECG
1495.jpg,432,288,N,1,277,426661,426938,MIT_BIH_ECG
1496.jpg,432,288,N,1,287,426938,427225,MIT_BIH_ECG
1497.jpg,432,288,N,1,298,427225,427523,MIT_BIH_ECG
1498.jpg,432,288,N,1,304,427523,427827,MIT_BIH_ECG
1499.jpg,432,288,N,1,302,427827,428129,MIT_BIH_ECG
1500.jpg,432,288,N,1,284,428129,428413,MIT_BIH_ECG
1501.jpg,432,288,N,1,285,428413,428698,MIT_BIH_ECG
1502.jpg,432,288,N,1,294,428698,428992,MIT_BIH_ECG
1503.jpg,432,288,N,1,284,428992,429276,MIT_BIH_ECG
1504.jpg,432,288,N,1,282,429276,429558,MIT_BIH_ECG
1505.jpg,432,288,N,1,309,429558,429867,MIT_BIH_ECG
1506.jpg,432,288,N,1,298,429867,430165,MIT_BIH_ECG
1507.jpg,432,288,N,1,305,430165,430470,MIT_BIH_ECG
1508.jpg,432,288,N,1,284,430470,430754,MIT_BIH_ECG
1509.jpg,432,288,N,1,280,430754,431034,MIT_BIH_ECG
1510.jpg,432,288,N,1,281,431034,431315,MIT_BIH_ECG
1511.jpg,432,288,N,1,300,431315,431615,MIT_BIH_ECG
1512.jpg,432,288,N,1,295,431615,431910,MIT_BIH_ECG
1513.jpg,432,288,N,1,299,431910,432209,MIT_BIH_ECG
1514.jpg,432,288,N,1,300,432209,432509,MIT_BIH_ECG
1515.jpg,432,288,N,1,290,432509,432799,MIT_BIH_ECG
1516.jpg,432,288,N,1,283,432799,433082,MIT_BIH_ECG
1517.jpg,432,288,N,1,282,433082,433364,MIT_BIH_ECG
1518.jpg,432,288,N,1,284,433364,433648,MIT_BIH_ECG
1519.jpg,432,288,N,1,193,433648,433841,MIT_BIH_ECG
1520.jpg,432,288,A_A,0,370,433841,434211,MIT_BIH_ECG
1521.jpg,432,288,N,1,302,434211,434513,MIT_BIH_ECG
1522.jpg,432,288,N,1,297,434513,434810,MIT_BIH_ECG
1523.jpg,432,288,N,1,286,434810,435096,MIT_BIH_ECG
1524.jpg,432,288,N,1,274,435096,435370,MIT_BIH_ECG
1525.jpg,432,288,N,1,288,435370,435658,MIT_BIH_ECG
1526.jpg,432,288,N,1,293,435658,435951,MIT_BIH_ECG
1527.jpg,432,288,N,1,198,435951,436149,MIT_BIH_ECG
1528.jpg,432,288,A_A,0,363,436149,436512,MIT_BIH_ECG
1529.jpg,432,288,N,1,307,436512,436819,MIT_BIH_ECG
1530.jpg,432,288,N,1,299,436819,437118,MIT_BIH_ECG
1531.jpg,432,288,N,1,282,437118,437400,MIT_BIH_ECG
1532.jpg,432,288,N,1,282,437400,437682,MIT_BIH_ECG
1533.jpg,432,288,N,1,283,437682,437965,MIT_BIH_ECG
1534.jpg,432,288,N,1,303,437965,438268,MIT_BIH_ECG
1535.jpg,432,288,N,1,302,438268,438570,MIT_BIH_ECG
1536.jpg,432,288,N,1,295,438570,438865,MIT_BIH_ECG
1537.jpg,432,288,N,1,293,438865,439158,MIT_BIH_ECG
1538.jpg,432,288,N,1,296,439158,439454,MIT_BIH_ECG
1539.jpg,432,288,N,1,286,439454,439740,MIT_BIH_ECG
1540.jpg,432,288,N,1,282,439740,440022,MIT_BIH_ECG
1541.jpg,432,288,N,1,290,440022,440312,MIT_BIH_ECG
1542.jpg,432,288,N,1,310,440312,440622,MIT_BIH_ECG
1543.jpg,432,288,N,1,312,440622,440934,MIT_BIH_ECG
1544.jpg,432,288,N,1,296,440934,441230,MIT_BIH_ECG
1545.jpg,432,288,N,1,288,441230,441518,MIT_BIH_ECG
1546.jpg,432,288,N,1,296,441518,441814,MIT_BIH_ECG
1547.jpg,432,288,N,1,295,441814,442109,MIT_BIH_ECG
1548.jpg,432,288,N,1,297,442109,442406,MIT_BIH_ECG
1549.jpg,432,288,N,1,217,442406,442623,MIT_BIH_ECG
1550.jpg,432,288,A_A,0,369,442623,442992,MIT_BIH_ECG
1551.jpg,432,288,N,1,312,442992,443304,MIT_BIH_ECG
1552.jpg,432,288,N,1,302,443304,443606,MIT_BIH_ECG
1553.jpg,432,288,N,1,282,443606,443888,MIT_BIH_ECG
1554.jpg,432,288,N,1,287,443888,444175,MIT_BIH_ECG
1555.jpg,432,288,N,1,298,444175,444473,MIT_BIH_ECG
1556.jpg,432,288,N,1,232,444473,444705,MIT_BIH_ECG
1557.jpg,432,288,A_A,0,355,444705,445060,MIT_BIH_ECG
1558.jpg,432,288,N,1,302,445060,445362,MIT_BIH_ECG
1559.jpg,432,288,N,1,296,445362,445658,MIT_BIH_ECG
1560.jpg,432,288,N,1,290,445658,445948,MIT_BIH_ECG
1561.jpg,432,288,N,1,278,445948,446226,MIT_BIH_ECG
1562.jpg,432,288,N,1,281,446226,446507,MIT_BIH_ECG
1563.jpg,432,288,N,1,293,446507,446800,MIT_BIH_ECG
1564.jpg,432,288,N,1,304,446800,447104,MIT_BIH_ECG
1565.jpg,432,288,N,1,298,447104,447402,MIT_BIH_ECG
1566.jpg,432,288,N,1,293,447402,447695,MIT_BIH_ECG
1567.jpg,432,288,N,1,285,447695,447980,MIT_BIH_ECG
1568.jpg,432,288,N,1,284,447980,448264,MIT_BIH_ECG
1569.jpg,432,288,N,1,284,448264,448548,MIT_BIH_ECG
1570.jpg,432,288,N,1,286,448548,448834,MIT_BIH_ECG
1571.jpg,432,288,N,1,303,448834,449137,MIT_BIH_ECG
1572.jpg,432,288,N,1,304,449137,449441,MIT_BIH_ECG
1573.jpg,432,288,N,1,307,449441,449748,MIT_BIH_ECG
1574.jpg,432,288,N,1,290,449748,450038,MIT_BIH_ECG
1575.jpg,432,288,N,1,287,450038,450325,MIT_BIH_ECG
1576.jpg,432,288,N,1,282,450325,450607,MIT_BIH_ECG
1577.jpg,432,288,N,1,288,450607,450895,MIT_BIH_ECG
1578.jpg,432,288,N,1,298,450895,451193,MIT_BIH_ECG
1579.jpg,432,288,N,1,308,451193,451501,MIT_BIH_ECG
1580.jpg,432,288,N,1,304,451501,451805,MIT_BIH_ECG
1581.jpg,432,288,N,1,296,451805,452101,MIT_BIH_ECG
1582.jpg,432,288,N,1,289,452101,452390,MIT_BIH_ECG
1583.jpg,432,288,N,1,288,452390,452678,MIT_BIH_ECG
1584.jpg,432,288,N,1,281,452678,452959,MIT_BIH_ECG
1585.jpg,432,288,N,1,291,452959,453250,MIT_BIH_ECG
1586.jpg,432,288,N,1,295,453250,453545,MIT_BIH_ECG
1587.jpg,432,288,N,1,307,453545,453852,MIT_BIH_ECG
1588.jpg,432,288,N,1,302,453852,454154,MIT_BIH_ECG
1589.jpg,432,288,N,1,290,454154,454444,MIT_BIH_ECG
1590.jpg,432,288,N,1,207,454444,454651,MIT_BIH_ECG
1591.jpg,432,288,A_A,0,346,454651,454997,MIT_BIH_ECG
1592.jpg,432,288,N,1,296,454997,455293,MIT_BIH_ECG
1593.jpg,432,288,N,1,295,455293,455588,MIT_BIH_ECG
1594.jpg,432,288,N,1,300,455588,455888,MIT_BIH_ECG
1595.jpg,432,288,N,1,301,455888,456189,MIT_BIH_ECG
1596.jpg,432,288,N,1,298,456189,456487,MIT_BIH_ECG
1597.jpg,432,288,N,1,284,456487,456771,MIT_BIH_ECG
1598.jpg,432,288,N,1,274,456771,457045,MIT_BIH_ECG
1599.jpg,432,288,N,1,288,457045,457333,MIT_BIH_ECG
1600.jpg,432,288,N,1,301,457333,457634,MIT_BIH_ECG
1601.jpg,432,288,N,1,303,457634,457937,MIT_BIH_ECG
1602.jpg,432,288,N,1,231,457937,458168,MIT_BIH_ECG
1603.jpg,432,288,A_A,0,356,458168,458524,MIT_BIH_ECG
1604.jpg,432,288,N,1,292,458524,458816,MIT_BIH_ECG
1605.jpg,432,288,N,1,287,458816,459103,MIT_BIH_ECG
1606.jpg,432,288,N,1,277,459103,459380,MIT_BIH_ECG
1607.jpg,432,288,N,1,284,459380,459664,MIT_BIH_ECG
1608.jpg,432,288,N,1,302,459664,459966,MIT_BIH_ECG
1609.jpg,432,288,N,1,309,459966,460275,MIT_BIH_ECG
1610.jpg,432,288,N,1,296,460275,460571,MIT_BIH_ECG
1611.jpg,432,288,N,1,287,460571,460858,MIT_BIH_ECG
1612.jpg,432,288,N,1,290,460858,461148,MIT_BIH_ECG
1613.jpg,432,288,N,1,285,461148,461433,MIT_BIH_ECG
1614.jpg,432,288,N,1,288,461433,461721,MIT_BIH_ECG
1615.jpg,432,288,N,1,293,461721,462014,MIT_BIH_ECG
1616.jpg,432,288,N,1,300,462014,462314,MIT_BIH_ECG
1617.jpg,432,288,N,1,307,462314,462621,MIT_BIH_ECG
1618.jpg,432,288,N,1,298,462621,462919,MIT_BIH_ECG
1619.jpg,432,288,N,1,278,462919,463197,MIT_BIH_ECG
1620.jpg,432,288,N,1,284,463197,463481,MIT_BIH_ECG
1621.jpg,432,288,N,1,284,463481,463765,MIT_BIH_ECG
1622.jpg,432,288,N,1,284,463765,464049,MIT_BIH_ECG
1623.jpg,432,288,N,1,312,464049,464361,MIT_BIH_ECG
1624.jpg,432,288,N,1,303,464361,464664,MIT_BIH_ECG
1625.jpg,432,288,N,1,296,464664,464960,MIT_BIH_ECG
1626.jpg,432,288,N,1,297,464960,465257,MIT_BIH_ECG
1627.jpg,432,288,N,1,281,465257,465538,MIT_BIH_ECG
1628.jpg,432,288,N,1,282,465538,465820,MIT_BIH_ECG
1629.jpg,432,288,N,1,284,465820,466104,MIT_BIH_ECG
1630.jpg,432,288,N,1,300,466104,466404,MIT_BIH_ECG
1631.jpg,432,288,N,1,303,466404,466707,MIT_BIH_ECG
1632.jpg,432,288,N,1,303,466707,467010,MIT_BIH_ECG
1633.jpg,432,288,N,1,298,467010,467308,MIT_BIH_ECG
1634.jpg,432,288,N,1,281,467308,467589,MIT_BIH_ECG
1635.jpg,432,288,N,1,289,467589,467878,MIT_BIH_ECG
1636.jpg,432,288,N,1,286,467878,468164,MIT_BIH_ECG
1637.jpg,432,288,N,1,295,468164,468459,MIT_BIH_ECG
1638.jpg,432,288,N,1,303,468459,468762,MIT_BIH_ECG
1639.jpg,432,288,N,1,303,468762,469065,MIT_BIH_ECG
1640.jpg,432,288,N,1,298,469065,469363,MIT_BIH_ECG
1641.jpg,432,288,N,1,297,469363,469660,MIT_BIH_ECG
1642.jpg,432,288,N,1,282,469660,469942,MIT_BIH_ECG
1643.jpg,432,288,N,1,288,469942,470230,MIT_BIH_ECG
1644.jpg,432,288,N,1,300,470230,470530,MIT_BIH_ECG
1645.jpg,432,288,N,1,307,470530,470837,MIT_BIH_ECG
1646.jpg,432,288,N,1,302,470837,471139,MIT_BIH_ECG
1647.jpg,432,288,N,1,305,471139,471444,MIT_BIH_ECG
1648.jpg,432,288,N,1,283,471444,471727,MIT_BIH_ECG
1649.jpg,432,288,N,1,292,471727,472019,MIT_BIH_ECG
1650.jpg,432,288,N,1,285,472019,472304,MIT_BIH_ECG
1651.jpg,432,288,N,1,285,472304,472589,MIT_BIH_ECG
1652.jpg,432,288,N,1,298,472589,472887,MIT_BIH_ECG
1653.jpg,432,288,N,1,314,472887,473201,MIT_BIH_ECG
1654.jpg,432,288,N,1,297,473201,473498,MIT_BIH_ECG
1655.jpg,432,288,N,1,294,473498,473792,MIT_BIH_ECG
1656.jpg,432,288,N,1,282,473792,474074,MIT_BIH_ECG
1657.jpg,432,288,N,1,288,474074,474362,MIT_BIH_ECG
1658.jpg,432,288,N,1,290,474362,474652,MIT_BIH_ECG
1659.jpg,432,288,N,1,290,474652,474942,MIT_BIH_ECG
1660.jpg,432,288,N,1,295,474942,475237,MIT_BIH_ECG
1661.jpg,432,288,N,1,310,475237,475547,MIT_BIH_ECG
1662.jpg,432,288,N,1,304,475547,475851,MIT_BIH_ECG
1663.jpg,432,288,N,1,285,475851,476136,MIT_BIH_ECG
1664.jpg,432,288,N,1,281,476136,476417,MIT_BIH_ECG
1665.jpg,432,288,N,1,288,476417,476705,MIT_BIH_ECG
1666.jpg,432,288,N,1,295,476705,477000,MIT_BIH_ECG
1667.jpg,432,288,N,1,307,477000,477307,MIT_BIH_ECG
1668.jpg,432,288,N,1,297,477307,477604,MIT_BIH_ECG
1669.jpg,432,288,N,1,294,477604,477898,MIT_BIH_ECG
1670.jpg,432,288,N,1,297,477898,478195,MIT_BIH_ECG
1671.jpg,432,288,N,1,285,478195,478480,MIT_BIH_ECG
1672.jpg,432,288,N,1,277,478480,478757,MIT_BIH_ECG
1673.jpg,432,288,N,1,283,478757,479040,MIT_BIH_ECG
1674.jpg,432,288,N,1,292,479040,479332,MIT_BIH_ECG
1675.jpg,432,288,N,1,301,479332,479633,MIT_BIH_ECG
1676.jpg,432,288,N,1,298,479633,479931,MIT_BIH_ECG
1677.jpg,432,288,N,1,287,479931,480218,MIT_BIH_ECG
1678.jpg,432,288,N,1,276,480218,480494,MIT_BIH_ECG
1679.jpg,432,288,N,1,285,480494,480779,MIT_BIH_ECG
1680.jpg,432,288,N,1,278,480779,481057,MIT_BIH_ECG
1681.jpg,432,288,N,1,283,481057,481340,MIT_BIH_ECG
1682.jpg,432,288,N,1,301,481340,481641,MIT_BIH_ECG
1683.jpg,432,288,N,1,300,481641,481941,MIT_BIH_ECG
1684.jpg,432,288,N,1,298,481941,482239,MIT_BIH_ECG
1685.jpg,432,288,N,1,286,482239,482525,MIT_BIH_ECG
1686.jpg,432,288,N,1,276,482525,482801,MIT_BIH_ECG
1687.jpg,432,288,N,1,270,482801,483071,MIT_BIH_ECG
1688.jpg,432,288,N,1,279,483071,483350,MIT_BIH_ECG
1689.jpg,432,288,N,1,284,483350,483634,MIT_BIH_ECG
1690.jpg,432,288,N,1,296,483634,483930,MIT_BIH_ECG
1691.jpg,432,288,N,1,290,483930,484220,MIT_BIH_ECG
1692.jpg,432,288,N,1,287,484220,484507,MIT_BIH_ECG
1693.jpg,432,288,N,1,279,484507,484786,MIT_BIH_ECG
1694.jpg,432,288,N,1,287,484786,485073,MIT_BIH_ECG
1695.jpg,432,288,N,1,279,485073,485352,MIT_BIH_ECG
1696.jpg,432,288,N,1,289,485352,485641,MIT_BIH_ECG
1697.jpg,432,288,N,1,298,485641,485939,MIT_BIH_ECG
1698.jpg,432,288,N,1,314,485939,486253,MIT_BIH_ECG
1699.jpg,432,288,N,1,303,486253,486556,MIT_BIH_ECG
1700.jpg,432,288,N,1,288,486556,486844,MIT_BIH_ECG
1701.jpg,432,288,N,1,285,486844,487129,MIT_BIH_ECG
1702.jpg,432,288,N,1,294,487129,487423,MIT_BIH_ECG
1703.jpg,432,288,N,1,296,487423,487719,MIT_BIH_ECG
1704.jpg,432,288,N,1,299,487719,488018,MIT_BIH_ECG
1705.jpg,432,288,N,1,302,488018,488320,MIT_BIH_ECG
1706.jpg,432,288,N,1,315,488320,488635,MIT_BIH_ECG
1707.jpg,432,288,N,1,296,488635,488931,MIT_BIH_ECG
1708.jpg,432,288,N,1,283,488931,489214,MIT_BIH_ECG
1709.jpg,432,288,N,1,283,489214,489497,MIT_BIH_ECG
1710.jpg,432,288,N,1,291,489497,489788,MIT_BIH_ECG
1711.jpg,432,288,N,1,302,489788,490090,MIT_BIH_ECG
1712.jpg,432,288,N,1,303,490090,490393,MIT_BIH_ECG
1713.jpg,432,288,N,1,302,490393,490695,MIT_BIH_ECG
1714.jpg,432,288,N,1,299,490695,490994,MIT_BIH_ECG
1715.jpg,432,288,N,1,293,490994,491287,MIT_BIH_ECG
1716.jpg,432,288,N,1,283,491287,491570,MIT_BIH_ECG
1717.jpg,432,288,N,1,280,491570,491850,MIT_BIH_ECG
1718.jpg,432,288,N,1,295,491850,492145,MIT_BIH_ECG
1719.jpg,432,288,N,1,300,492145,492445,MIT_BIH_ECG
1720.jpg,432,288,N,1,305,492445,492750,MIT_BIH_ECG
1721.jpg,432,288,N,1,296,492750,493046,MIT_BIH_ECG
1722.jpg,432,288,N,1,294,493046,493340,MIT_BIH_ECG
1723.jpg,432,288,N,1,283,493340,493623,MIT_BIH_ECG
1724.jpg,432,288,N,1,291,493623,493914,MIT_BIH_ECG
1725.jpg,432,288,N,1,285,493914,494199,MIT_BIH_ECG
1726.jpg,432,288,N,1,292,494199,494491,MIT_BIH_ECG
1727.jpg,432,288,N,1,298,494491,494789,MIT_BIH_ECG
1728.jpg,432,288,N,1,296,494789,495085,MIT_BIH_ECG
1729.jpg,432,288,N,1,285,495085,495370,MIT_BIH_ECG
1730.jpg,432,288,N,1,279,495370,495649,MIT_BIH_ECG
1731.jpg,432,288,N,1,275,495649,495924,MIT_BIH_ECG
1732.jpg,432,288,N,1,277,495924,496201,MIT_BIH_ECG
1733.jpg,432,288,N,1,298,496201,496499,MIT_BIH_ECG
1734.jpg,432,288,N,1,213,496499,496712,MIT_BIH_ECG
1735.jpg,432,288,A_A,0,362,496712,497074,MIT_BIH_ECG
1736.jpg,432,288,N,1,302,497074,497376,MIT_BIH_ECG
1737.jpg,432,288,N,1,288,497376,497664,MIT_BIH_ECG
1738.jpg,432,288,N,1,281,497664,497945,MIT_BIH_ECG
1739.jpg,432,288,N,1,285,497945,498230,MIT_BIH_ECG
1740.jpg,432,288,N,1,287,498230,498517,MIT_BIH_ECG
1741.jpg,432,288,N,1,295,498517,498812,MIT_BIH_ECG
1742.jpg,432,288,N,1,302,498812,499114,MIT_BIH_ECG
1743.jpg,432,288,N,1,303,499114,499417,MIT_BIH_ECG
1744.jpg,432,288,N,1,284,499417,499701,MIT_BIH_ECG
1745.jpg,432,288,N,1,286,499701,499987,MIT_BIH_ECG
1746.jpg,432,288,N,1,281,499987,500268,MIT_BIH_ECG
1747.jpg,432,288,N,1,281,500268,500549,MIT_BIH_ECG
1748.jpg,432,288,N,1,298,500549,500847,MIT_BIH_ECG
1749.jpg,432,288,N,1,298,500847,501145,MIT_BIH_ECG
1750.jpg,432,288,N,1,303,501145,501448,MIT_BIH_ECG
1751.jpg,432,288,N,1,297,501448,501745,MIT_BIH_ECG
1752.jpg,432,288,N,1,294,501745,502039,MIT_BIH_ECG
1753.jpg,432,288,N,1,277,502039,502316,MIT_BIH_ECG
1754.jpg,432,288,N,1,285,502316,502601,MIT_BIH_ECG
1755.jpg,432,288,N,1,287,502601,502888,MIT_BIH_ECG
1756.jpg,432,288,N,1,303,502888,503191,MIT_BIH_ECG
1757.jpg,432,288,N,1,305,503191,503496,MIT_BIH_ECG
1758.jpg,432,288,N,1,298,503496,503794,MIT_BIH_ECG
1759.jpg,432,288,N,1,286,503794,504080,MIT_BIH_ECG
1760.jpg,432,288,N,1,292,504080,504372,MIT_BIH_ECG
1761.jpg,432,288,N,1,282,504372,504654,MIT_BIH_ECG
1762.jpg,432,288,N,1,282,504654,504936,MIT_BIH_ECG
1763.jpg,432,288,N,1,291,504936,505227,MIT_BIH_ECG
1764.jpg,432,288,N,1,301,505227,505528,MIT_BIH_ECG
1765.jpg,432,288,N,1,302,505528,505830,MIT_BIH_ECG
1766.jpg,432,288,N,1,295,505830,506125,MIT_BIH_ECG
1767.jpg,432,288,N,1,273,506125,506398,MIT_BIH_ECG
1768.jpg,432,288,N,1,281,506398,506679,MIT_BIH_ECG
1769.jpg,432,288,N,1,290,506679,506969,MIT_BIH_ECG
1770.jpg,432,288,N,1,287,506969,507256,MIT_BIH_ECG
1771.jpg,432,288,N,1,296,507256,507552,MIT_BIH_ECG
1772.jpg,432,288,N,1,303,507552,507855,MIT_BIH_ECG
1773.jpg,432,288,N,1,304,507855,508159,MIT_BIH_ECG
1774.jpg,432,288,N,1,296,508159,508455,MIT_BIH_ECG
1775.jpg,432,288,N,1,289,508455,508744,MIT_BIH_ECG
1776.jpg,432,288,N,1,275,508744,509019,MIT_BIH_ECG
1777.jpg,432,288,N,1,300,509019,509319,MIT_BIH_ECG
1778.jpg,432,288,N,1,304,509319,509623,MIT_BIH_ECG
1779.jpg,432,288,N,1,300,509623,509923,MIT_BIH_ECG
1780.jpg,432,288,N,1,297,509923,510220,MIT_BIH_ECG
1781.jpg,432,288,N,1,300,510220,510520,MIT_BIH_ECG
1782.jpg,432,288,N,1,284,510520,510804,MIT_BIH_ECG
1783.jpg,432,288,N,1,289,510804,511093,MIT_BIH_ECG
1784.jpg,432,288,N,1,278,511093,511371,MIT_BIH_ECG
1785.jpg,432,288,N,1,289,511371,511660,MIT_BIH_ECG
1786.jpg,432,288,N,1,310,511660,511970,MIT_BIH_ECG
1787.jpg,432,288,N,1,307,511970,512277,MIT_BIH_ECG
1788.jpg,432,288,N,1,290,512277,512567,MIT_BIH_ECG
1789.jpg,432,288,N,1,284,512567,512851,MIT_BIH_ECG
1790.jpg,432,288,N,1,284,512851,513135,MIT_BIH_ECG
1791.jpg,432,288,N,1,289,513135,513424,MIT_BIH_ECG
1792.jpg,432,288,N,1,295,513424,513719,MIT_BIH_ECG
1793.jpg,432,288,N,1,295,513719,514014,MIT_BIH_ECG
1794.jpg,432,288,N,1,304,514014,514318,MIT_BIH_ECG
1795.jpg,432,288,N,1,310,514318,514628,MIT_BIH_ECG
1796.jpg,432,288,N,1,291,514628,514919,MIT_BIH_ECG
1797.jpg,432,288,N,1,275,514919,515194,MIT_BIH_ECG
1798.jpg,432,288,N,1,282,515194,515476,MIT_BIH_ECG
1799.jpg,432,288,N,1,286,515476,515762,MIT_BIH_ECG
1800.jpg,432,288,N,1,303,515762,516065,MIT_BIH_ECG
1801.jpg,432,288,N,1,306,516065,516371,MIT_BIH_ECG
1802.jpg,432,288,N,1,296,516371,516667,MIT_BIH_ECG
1803.jpg,432,288,N,1,303,516667,516970,MIT_BIH_ECG
1804.jpg,432,288,N,1,296,516970,517266,MIT_BIH_ECG
1805.jpg,432,288,N,1,287,517266,517553,MIT_BIH_ECG
1806.jpg,432,288,N,1,279,517553,517832,MIT_BIH_ECG
1807.jpg,432,288,N,1,295,517832,518127,MIT_BIH_ECG
1808.jpg,432,288,N,1,299,518127,518426,MIT_BIH_ECG
1809.jpg,432,288,N,1,308,518426,518734,MIT_BIH_ECG
1810.jpg,432,288,N,1,294,518734,519028,MIT_BIH_ECG
1811.jpg,432,288,N,1,279,519028,519307,MIT_BIH_ECG
1812.jpg,432,288,N,1,287,519307,519594,MIT_BIH_ECG
1813.jpg,432,288,N,1,288,519594,519882,MIT_BIH_ECG
1814.jpg,432,288,N,1,267,519882,520149,MIT_BIH_ECG
1815.jpg,432,288,N,1,314,520149,520463,MIT_BIH_ECG
1816.jpg,432,288,N,1,305,520463,520768,MIT_BIH_ECG
1817.jpg,432,288,N,1,214,520768,520982,MIT_BIH_ECG
1818.jpg,432,288,A_A,0,360,520982,521342,MIT_BIH_ECG
1819.jpg,432,288,N,1,285,521342,521627,MIT_BIH_ECG
1820.jpg,432,288,N,1,286,521627,521913,MIT_BIH_ECG
1821.jpg,432,288,N,1,296,521913,522209,MIT_BIH_ECG
1822.jpg,432,288,N,1,302,522209,522511,MIT_BIH_ECG
1823.jpg,432,288,N,1,304,522511,522815,MIT_BIH_ECG
1824.jpg,432,288,N,1,301,522815,523116,MIT_BIH_ECG
1825.jpg,432,288,N,1,300,523116,523416,MIT_BIH_ECG
1826.jpg,432,288,N,1,292,523416,523708,MIT_BIH_ECG
1827.jpg,432,288,N,1,291,523708,523999,MIT_BIH_ECG
1828.jpg,432,288,N,1,280,523999,524279,MIT_BIH_ECG
1829.jpg,432,288,N,1,298,524279,524577,MIT_BIH_ECG
1830.jpg,432,288,N,1,313,524577,524890,MIT_BIH_ECG
1831.jpg,432,288,N,1,308,524890,525198,MIT_BIH_ECG
1832.jpg,432,288,N,1,294,525198,525492,MIT_BIH_ECG
1833.jpg,432,288,N,1,288,525492,525780,MIT_BIH_ECG
1834.jpg,432,288,N,1,284,525780,526064,MIT_BIH_ECG
1835.jpg,432,288,N,1,291,526064,526355,MIT_BIH_ECG
1836.jpg,432,288,N,1,291,526355,526646,MIT_BIH_ECG
1837.jpg,432,288,N,1,295,526646,526941,MIT_BIH_ECG
1838.jpg,432,288,N,1,302,526941,527243,MIT_BIH_ECG
1839.jpg,432,288,N,1,306,527243,527549,MIT_BIH_ECG
1840.jpg,432,288,N,1,289,527549,527838,MIT_BIH_ECG
1841.jpg,432,288,N,1,280,527838,528118,MIT_BIH_ECG
1842.jpg,432,288,N,1,284,528118,528402,MIT_BIH_ECG
1843.jpg,432,288,N,1,287,528402,528689,MIT_BIH_ECG
1844.jpg,432,288,N,1,302,528689,528991,MIT_BIH_ECG
1845.jpg,432,288,N,1,302,528991,529293,MIT_BIH_ECG
1846.jpg,432,288,N,1,306,529293,529599,MIT_BIH_ECG
1847.jpg,432,288,N,1,298,529599,529897,MIT_BIH_ECG
1848.jpg,432,288,N,1,294,529897,530191,MIT_BIH_ECG
1849.jpg,432,288,N,1,280,530191,530471,MIT_BIH_ECG
1850.jpg,432,288,N,1,291,530471,530762,MIT_BIH_ECG
1851.jpg,432,288,N,1,295,530762,531057,MIT_BIH_ECG
1852.jpg,432,288,N,1,301,531057,531358,MIT_BIH_ECG
1853.jpg,432,288,N,1,310,531358,531668,MIT_BIH_ECG
1854.jpg,432,288,N,1,299,531668,531967,MIT_BIH_ECG
1855.jpg,432,288,N,1,290,531967,532257,MIT_BIH_ECG
1856.jpg,432,288,N,1,287,532257,532544,MIT_BIH_ECG
1857.jpg,432,288,N,1,284,532544,532828,MIT_BIH_ECG
1858.jpg,432,288,N,1,293,532828,533121,MIT_BIH_ECG
1859.jpg,432,288,N,1,295,533121,533416,MIT_BIH_ECG
1860.jpg,432,288,N,1,303,533416,533719,MIT_BIH_ECG
1861.jpg,432,288,N,1,293,533719,534012,MIT_BIH_ECG
1862.jpg,432,288,N,1,295,534012,534307,MIT_BIH_ECG
1863.jpg,432,288,N,1,285,534307,534592,MIT_BIH_ECG
1864.jpg,432,288,N,1,281,534592,534873,MIT_BIH_ECG
1865.jpg,432,288,N,1,288,534873,535161,MIT_BIH_ECG
1866.jpg,432,288,N,1,298,535161,535459,MIT_BIH_ECG
1867.jpg,432,288,N,1,309,535459,535768,MIT_BIH_ECG
1868.jpg,432,288,N,1,299,535768,536067,MIT_BIH_ECG
1869.jpg,432,288,N,1,297,536067,536364,MIT_BIH_ECG
1870.jpg,432,288,N,1,280,536364,536644,MIT_BIH_ECG
1871.jpg,432,288,N,1,286,536644,536930,MIT_BIH_ECG
1872.jpg,432,288,N,1,282,536930,537212,MIT_BIH_ECG
1873.jpg,432,288,N,1,293,537212,537505,MIT_BIH_ECG
1874.jpg,432,288,N,1,305,537505,537810,MIT_BIH_ECG
1875.jpg,432,288,N,1,305,537810,538115,MIT_BIH_ECG
1876.jpg,432,288,N,1,306,538115,538421,MIT_BIH_ECG
1877.jpg,432,288,N,1,286,538421,538707,MIT_BIH_ECG
1878.jpg,432,288,N,1,286,538707,538993,MIT_BIH_ECG
1879.jpg,432,288,N,1,285,538993,539278,MIT_BIH_ECG
1880.jpg,432,288,N,1,297,539278,539575,MIT_BIH_ECG
1881.jpg,432,288,N,1,299,539575,539874,MIT_BIH_ECG
1882.jpg,432,288,N,1,298,539874,540172,MIT_BIH_ECG
1883.jpg,432,288,N,1,300,540172,540472,MIT_BIH_ECG
1884.jpg,432,288,N,1,296,540472,540768,MIT_BIH_ECG
1885.jpg,432,288,N,1,284,540768,541052,MIT_BIH_ECG
1886.jpg,432,288,N,1,282,541052,541334,MIT_BIH_ECG
1887.jpg,432,288,N,1,282,541334,541616,MIT_BIH_ECG
1888.jpg,432,288,N,1,300,541616,541916,MIT_BIH_ECG
1889.jpg,432,288,N,1,310,541916,542226,MIT_BIH_ECG
1890.jpg,432,288,N,1,303,542226,542529,MIT_BIH_ECG
1891.jpg,432,288,N,1,296,542529,542825,MIT_BIH_ECG
1892.jpg,432,288,N,1,291,542825,543116,MIT_BIH_ECG
1893.jpg,432,288,N,1,291,543116,543407,MIT_BIH_ECG
1894.jpg,432,288,N,1,282,543407,543689,MIT_BIH_ECG
1895.jpg,432,288,N,1,294,543689,543983,MIT_BIH_ECG
1896.jpg,432,288,N,1,302,543983,544285,MIT_BIH_ECG
1897.jpg,432,288,N,1,305,544285,544590,MIT_BIH_ECG
1898.jpg,432,288,N,1,305,544590,544895,MIT_BIH_ECG
1899.jpg,432,288,N,1,287,544895,545182,MIT_BIH_ECG
1900.jpg,432,288,N,1,273,545182,545455,MIT_BIH_ECG
1901.jpg,432,288,N,1,286,545455,545741,MIT_BIH_ECG
1902.jpg,432,288,N,1,281,545741,546022,MIT_BIH_ECG
1903.jpg,432,288,N,1,284,546022,546306,MIT_BIH_ECG
1904.jpg,432,288,N,1,293,546306,546599,MIT_BIH_ECG
1905.jpg,432,288,N,1,193,546599,546792,MIT_BIH_ECG
1906.jpg,432,288,A_V,0,407,546792,547199,MIT_BIH_ECG
1907.jpg,432,288,N,1,283,547199,547482,MIT_BIH_ECG
1908.jpg,432,288,N,1,276,547482,547758,MIT_BIH_ECG
1909.jpg,432,288,N,1,274,547758,548032,MIT_BIH_ECG
1910.jpg,432,288,N,1,302,548032,548334,MIT_BIH_ECG
1911.jpg,432,288,N,1,298,548334,548632,MIT_BIH_ECG
1912.jpg,432,288,N,1,294,548632,548926,MIT_BIH_ECG
1913.jpg,432,288,N,1,291,548926,549217,MIT_BIH_ECG
1914.jpg,432,288,N,1,285,549217,549502,MIT_BIH_ECG
1915.jpg,432,288,N,1,282,549502,549784,MIT_BIH_ECG
1916.jpg,432,288,N,1,286,549784,550070,MIT_BIH_ECG
1917.jpg,432,288,N,1,278,550070,550348,MIT_BIH_ECG
1918.jpg,432,288,N,1,291,550348,550639,MIT_BIH_ECG
1919.jpg,432,288,N,1,313,550639,550952,MIT_BIH_ECG
1920.jpg,432,288,N,1,301,550952,551253,MIT_BIH_ECG
1921.jpg,432,288,N,1,279,551253,551532,MIT_BIH_ECG
1922.jpg,432,288,N,1,283,551532,551815,MIT_BIH_ECG
1923.jpg,432,288,N,1,281,551815,552096,MIT_BIH_ECG
1924.jpg,432,288,N,1,289,552096,552385,MIT_BIH_ECG
1925.jpg,432,288,N,1,295,552385,552680,MIT_BIH_ECG
1926.jpg,432,288,N,1,294,552680,552974,MIT_BIH_ECG
1927.jpg,432,288,N,1,308,552974,553282,MIT_BIH_ECG
1928.jpg,432,288,N,1,306,553282,553588,MIT_BIH_ECG
1929.jpg,432,288,N,1,288,553588,553876,MIT_BIH_ECG
1930.jpg,432,288,N,1,278,553876,554154,MIT_BIH_ECG
1931.jpg,432,288,N,1,285,554154,554439,MIT_BIH_ECG
1932.jpg,432,288,N,1,284,554439,554723,MIT_BIH_ECG
1933.jpg,432,288,N,1,303,554723,555026,MIT_BIH_ECG
1934.jpg,432,288,N,1,297,555026,555323,MIT_BIH_ECG
1935.jpg,432,288,N,1,290,555323,555613,MIT_BIH_ECG
1936.jpg,432,288,N,1,301,555613,555914,MIT_BIH_ECG
1937.jpg,432,288,N,1,289,555914,556203,MIT_BIH_ECG
1938.jpg,432,288,N,1,283,556203,556486,MIT_BIH_ECG
1939.jpg,432,288,N,1,279,556486,556765,MIT_BIH_ECG
1940.jpg,432,288,N,1,291,556765,557056,MIT_BIH_ECG
1941.jpg,432,288,N,1,305,557056,557361,MIT_BIH_ECG
1942.jpg,432,288,N,1,306,557361,557667,MIT_BIH_ECG
1943.jpg,432,288,N,1,295,557667,557962,MIT_BIH_ECG
1944.jpg,432,288,N,1,276,557962,558238,MIT_BIH_ECG
1945.jpg,432,288,N,1,289,558238,558527,MIT_BIH_ECG
1946.jpg,432,288,N,1,286,558527,558813,MIT_BIH_ECG
1947.jpg,432,288,N,1,289,558813,559102,MIT_BIH_ECG
1948.jpg,432,288,N,1,293,559102,559395,MIT_BIH_ECG
1949.jpg,432,288,N,1,300,559395,559695,MIT_BIH_ECG
1950.jpg,432,288,N,1,302,559695,559997,MIT_BIH_ECG
1951.jpg,432,288,N,1,298,559997,560295,MIT_BIH_ECG
1952.jpg,432,288,N,1,281,560295,560576,MIT_BIH_ECG
1953.jpg,432,288,N,1,270,560576,560846,MIT_BIH_ECG
1954.jpg,432,288,N,1,295,560846,561141,MIT_BIH_ECG
1955.jpg,432,288,N,1,294,561141,561435,MIT_BIH_ECG
1956.jpg,432,288,N,1,297,561435,561732,MIT_BIH_ECG
1957.jpg,432,288,N,1,287,561732,562019,MIT_BIH_ECG
1958.jpg,432,288,N,1,289,562019,562308,MIT_BIH_ECG
1959.jpg,432,288,N,1,283,562308,562591,MIT_BIH_ECG
1960.jpg,432,288,N,1,221,562591,562812,MIT_BIH_ECG
1961.jpg,432,288,A_A,0,329,562812,563141,MIT_BIH_ECG
1962.jpg,432,288,N,1,282,563141,563423,MIT_BIH_ECG
1963.jpg,432,288,N,1,308,563423,563731,MIT_BIH_ECG
1964.jpg,432,288,N,1,299,563731,564030,MIT_BIH_ECG
1965.jpg,432,288,N,1,290,564030,564320,MIT_BIH_ECG
1966.jpg,432,288,N,1,281,564320,564601,MIT_BIH_ECG
1967.jpg,432,288,N,1,282,564601,564883,MIT_BIH_ECG
1968.jpg,432,288,N,1,281,564883,565164,MIT_BIH_ECG
1969.jpg,432,288,N,1,288,565164,565452,MIT_BIH_ECG
1970.jpg,432,288,N,1,289,565452,565741,MIT_BIH_ECG
1971.jpg,432,288,N,1,300,565741,566041,MIT_BIH_ECG
1972.jpg,432,288,N,1,218,566041,566259,MIT_BIH_ECG
1973.jpg,432,288,A_A,0,356,566259,566615,MIT_BIH_ECG
1974.jpg,432,288,N,1,284,566615,566899,MIT_BIH_ECG
1975.jpg,432,288,N,1,286,566899,567185,MIT_BIH_ECG
1976.jpg,432,288,N,1,194,567185,567379,MIT_BIH_ECG
1977.jpg,432,288,A_A,0,342,567379,567721,MIT_BIH_ECG
1978.jpg,432,288,N,1,306,567721,568027,MIT_BIH_ECG
1979.jpg,432,288,N,1,299,568027,568326,MIT_BIH_ECG
1980.jpg,432,288,N,1,298,568326,568624,MIT_BIH_ECG
1981.jpg,432,288,N,1,295,568624,568919,MIT_BIH_ECG
1982.jpg,432,288,N,1,285,568919,569204,MIT_BIH_ECG
1983.jpg,432,288,N,1,278,569204,569482,MIT_BIH_ECG
1984.jpg,432,288,N,1,280,569482,569762,MIT_BIH_ECG
1985.jpg,432,288,N,1,296,569762,570058,MIT_BIH_ECG
1986.jpg,432,288,N,1,308,570058,570366,MIT_BIH_ECG
1987.jpg,432,288,N,1,302,570366,570668,MIT_BIH_ECG
1988.jpg,432,288,N,1,289,570668,570957,MIT_BIH_ECG
1989.jpg,432,288,N,1,289,570957,571246,MIT_BIH_ECG
1990.jpg,432,288,N,1,292,571246,571538,MIT_BIH_ECG
1991.jpg,432,288,N,1,293,571538,571831,MIT_BIH_ECG
1992.jpg,432,288,N,1,291,571831,572122,MIT_BIH_ECG
1993.jpg,432,288,N,1,306,572122,572428,MIT_BIH_ECG
1994.jpg,432,288,N,1,302,572428,572730,MIT_BIH_ECG
1995.jpg,432,288,N,1,310,572730,573040,MIT_BIH_ECG
1996.jpg,432,288,N,1,288,573040,573328,MIT_BIH_ECG
1997.jpg,432,288,N,1,280,573328,573608,MIT_BIH_ECG
1998.jpg,432,288,N,1,285,573608,573893,MIT_BIH_ECG
1999.jpg,432,288,N,1,300,573893,574193,MIT_BIH_ECG
2000.jpg,432,288,N,1,236,574193,574429,MIT_BIH_ECG
2001.jpg,432,288,A_A,0,357,574429,574786,MIT_BIH_ECG
2002.jpg,432,288,N,1,309,574786,575095,MIT_BIH_ECG
2003.jpg,432,288,N,1,292,575095,575387,MIT_BIH_ECG
2004.jpg,432,288,N,1,291,575387,575678,MIT_BIH_ECG
2005.jpg,432,288,N,1,281,575678,575959,MIT_BIH_ECG
2006.jpg,432,288,N,1,289,575959,576248,MIT_BIH_ECG
2007.jpg,432,288,N,1,303,576248,576551,MIT_BIH_ECG
2008.jpg,432,288,N,1,311,576551,576862,MIT_BIH_ECG
2009.jpg,432,288,N,1,300,576862,577162,MIT_BIH_ECG
2010.jpg,432,288,N,1,294,577162,577456,MIT_BIH_ECG
2011.jpg,432,288,N,1,285,577456,577741,MIT_BIH_ECG
2012.jpg,432,288,N,1,284,577741,578025,MIT_BIH_ECG
2013.jpg,432,288,N,1,285,578025,578310,MIT_BIH_ECG
2014.jpg,432,288,N,1,290,578310,578600,MIT_BIH_ECG
2015.jpg,432,288,N,1,301,578600,578901,MIT_BIH_ECG
2016.jpg,432,288,N,1,303,578901,579204,MIT_BIH_ECG
2017.jpg,432,288,N,1,244,579204,579448,MIT_BIH_ECG
2018.jpg,432,288,A_A,0,342,579448,579790,MIT_BIH_ECG
2019.jpg,432,288,N,1,284,579790,580074,MIT_BIH_ECG
2020.jpg,432,288,N,1,283,580074,580357,MIT_BIH_ECG
2021.jpg,432,288,N,1,291,580357,580648,MIT_BIH_ECG
2022.jpg,432,288,N,1,299,580648,580947,MIT_BIH_ECG
2023.jpg,432,288,N,1,299,580947,581246,MIT_BIH_ECG
2024.jpg,432,288,N,1,297,581246,581543,MIT_BIH_ECG
2025.jpg,432,288,N,1,291,581543,581834,MIT_BIH_ECG
2026.jpg,432,288,N,1,285,581834,582119,MIT_BIH_ECG
2027.jpg,432,288,N,1,276,582119,582395,MIT_BIH_ECG
2028.jpg,432,288,N,1,273,582395,582668,MIT_BIH_ECG
2029.jpg,432,288,N,1,251,582668,582919,MIT_BIH_ECG
2030.jpg,432,288,N,1,320,582919,583239,MIT_BIH_ECG
2031.jpg,432,288,N,1,300,583239,583539,MIT_BIH_ECG
2032.jpg,432,288,N,1,282,583539,583821,MIT_BIH_ECG
2033.jpg,432,288,N,1,276,583821,584097,MIT_BIH_ECG
2034.jpg,432,288,N,1,266,584097,584363,MIT_BIH_ECG
2035.jpg,432,288,N,1,272,584363,584635,MIT_BIH_ECG
2036.jpg,432,288,N,1,268,584635,584903,MIT_BIH_ECG
2037.jpg,432,288,N,1,272,584903,585175,MIT_BIH_ECG
2038.jpg,432,288,N,1,279,585175,585454,MIT_BIH_ECG
2039.jpg,432,288,N,1,277,585454,585731,MIT_BIH_ECG
2040.jpg,432,288,N,1,280,585731,586011,MIT_BIH_ECG
2041.jpg,432,288,N,1,264,586011,586275,MIT_BIH_ECG
2042.jpg,432,288,N,1,250,586275,586525,MIT_BIH_ECG
2043.jpg,432,288,N,1,246,586525,586771,MIT_BIH_ECG
2044.jpg,432,288,N,1,259,586771,587030,MIT_BIH_ECG
2045.jpg,432,288,N,1,269,587030,587299,MIT_BIH_ECG
2046.jpg,432,288,N,1,273,587299,587572,MIT_BIH_ECG
2047.jpg,432,288,N,1,271,587572,587843,MIT_BIH_ECG
2048.jpg,432,288,N,1,270,587843,588113,MIT_BIH_ECG
2049.jpg,432,288,N,1,264,588113,588377,MIT_BIH_ECG
2050.jpg,432,288,N,1,266,588377,588643,MIT_BIH_ECG
2051.jpg,432,288,N,1,262,588643,588905,MIT_BIH_ECG
2052.jpg,432,288,N,1,272,588905,589177,MIT_BIH_ECG
2053.jpg,432,288,N,1,277,589177,589454,MIT_BIH_ECG
2054.jpg,432,288,N,1,293,589454,589747,MIT_BIH_ECG
2055.jpg,432,288,N,1,293,589747,590040,MIT_BIH_ECG
2056.jpg,432,288,N,1,276,590040,590316,MIT_BIH_ECG
2057.jpg,432,288,N,1,272,590316,590588,MIT_BIH_ECG
2058.jpg,432,288,N,1,275,590588,590863,MIT_BIH_ECG
2059.jpg,432,288,N,1,280,590863,591143,MIT_BIH_ECG
2060.jpg,432,288,N,1,274,591143,591417,MIT_BIH_ECG
2061.jpg,432,288,N,1,289,591417,591706,MIT_BIH_ECG
2062.jpg,432,288,N,1,293,591706,591999,MIT_BIH_ECG
2063.jpg,432,288,N,1,289,591999,592288,MIT_BIH_ECG
2064.jpg,432,288,N,1,283,592288,592571,MIT_BIH_ECG
2065.jpg,432,288,N,1,282,592571,592853,MIT_BIH_ECG
2066.jpg,432,288,N,1,215,592853,593068,MIT_BIH_ECG
2067.jpg,432,288,A_A,0,319,593068,593387,MIT_BIH_ECG
2068.jpg,432,288,N,1,296,593387,593683,MIT_BIH_ECG
2069.jpg,432,288,N,1,307,593683,593990,MIT_BIH_ECG
2070.jpg,432,288,N,1,290,593990,594280,MIT_BIH_ECG
2071.jpg,432,288,N,1,283,594280,594563,MIT_BIH_ECG
2072.jpg,432,288,N,1,292,594563,594855,MIT_BIH_ECG
2073.jpg,432,288,N,1,272,594855,595127,MIT_BIH_ECG
2074.jpg,432,288,N,1,275,595127,595402,MIT_BIH_ECG
2075.jpg,432,288,N,1,288,595402,595690,MIT_BIH_ECG
2076.jpg,432,288,N,1,302,595690,595992,MIT_BIH_ECG
2077.jpg,432,288,N,1,286,595992,596278,MIT_BIH_ECG
2078.jpg,432,288,N,1,306,596278,596584,MIT_BIH_ECG
2079.jpg,432,288,N,1,295,596584,596879,MIT_BIH_ECG
2080.jpg,432,288,N,1,257,596879,597136,MIT_BIH_ECG
2081.jpg,432,288,N,1,266,597136,597402,MIT_BIH_ECG
2082.jpg,432,288,N,1,268,597402,597670,MIT_BIH_ECG
2083.jpg,432,288,N,1,255,597670,597925,MIT_BIH_ECG
2084.jpg,432,288,N,1,261,597925,598186,MIT_BIH_ECG
2085.jpg,432,288,N,1,272,598186,598458,MIT_BIH_ECG
2086.jpg,432,288,N,1,255,598458,598713,MIT_BIH_ECG
2087.jpg,432,288,N,1,256,598713,598969,MIT_BIH_ECG
2088.jpg,432,288,N,1,253,598969,599222,MIT_BIH_ECG
2089.jpg,432,288,N,1,246,599222,599468,MIT_BIH_ECG
2090.jpg,432,288,N,1,235,599468,599703,MIT_BIH_ECG
2091.jpg,432,288,N,1,249,599703,599952,MIT_BIH_ECG
2092.jpg,432,288,N,1,262,599952,600214,MIT_BIH_ECG
2093.jpg,432,288,N,1,269,600214,600483,MIT_BIH_ECG
2094.jpg,432,288,N,1,256,600483,600739,MIT_BIH_ECG
2095.jpg,432,288,N,1,272,600739,601011,MIT_BIH_ECG
2096.jpg,432,288,N,1,262,601011,601273,MIT_BIH_ECG
2097.jpg,432,288,N,1,264,601273,601537,MIT_BIH_ECG
2098.jpg,432,288,N,1,262,601537,601799,MIT_BIH_ECG
2099.jpg,432,288,N,1,265,601799,602064,MIT_BIH_ECG
2100.jpg,432,288,N,1,266,602064,602330,MIT_BIH_ECG
2101.jpg,432,288,N,1,280,602330,602610,MIT_BIH_ECG
2102.jpg,432,288,N,1,283,602610,602893,MIT_BIH_ECG
2103.jpg,432,288,N,1,286,602893,603179,MIT_BIH_ECG
2104.jpg,432,288,N,1,276,603179,603455,MIT_BIH_ECG
2105.jpg,432,288,N,1,267,603455,603722,MIT_BIH_ECG
2106.jpg,432,288,N,1,267,603722,603989,MIT_BIH_ECG
2107.jpg,432,288,N,1,288,603989,604277,MIT_BIH_ECG
2108.jpg,432,288,N,1,287,604277,604564,MIT_BIH_ECG
2109.jpg,432,288,N,1,280,604564,604844,MIT_BIH_ECG
2110.jpg,432,288,N,1,304,604844,605148,MIT_BIH_ECG
2111.jpg,432,288,N,1,311,605148,605459,MIT_BIH_ECG
2112.jpg,432,288,N,1,278,605459,605737,MIT_BIH_ECG
2113.jpg,432,288,N,1,271,605737,606008,MIT_BIH_ECG
2114.jpg,432,288,N,1,285,606008,606293,MIT_BIH_ECG
2115.jpg,432,288,N,1,294,606293,606587,MIT_BIH_ECG
2116.jpg,432,288,N,1,293,606587,606880,MIT_BIH_ECG
2117.jpg,432,288,N,1,298,606880,607178,MIT_BIH_ECG
2118.jpg,432,288,N,1,297,607178,607475,MIT_BIH_ECG
2119.jpg,432,288,N,1,291,607475,607766,MIT_BIH_ECG
2120.jpg,432,288,N,1,277,607766,608043,MIT_BIH_ECG
2121.jpg,432,288,N,1,266,608043,608309,MIT_BIH_ECG
2122.jpg,432,288,N,1,267,608309,608576,MIT_BIH_ECG
2123.jpg,432,288,N,1,277,608576,608853,MIT_BIH_ECG
2124.jpg,432,288,N,1,283,608853,609136,MIT_BIH_ECG
2125.jpg,432,288,N,1,289,609136,609425,MIT_BIH_ECG
2126.jpg,432,288,N,1,290,609425,609715,MIT_BIH_ECG
2127.jpg,432,288,N,1,272,609715,609987,MIT_BIH_ECG
2128.jpg,432,288,N,1,275,609987,610262,MIT_BIH_ECG
2129.jpg,432,288,N,1,282,610262,610544,MIT_BIH_ECG
2130.jpg,432,288,N,1,279,610544,610823,MIT_BIH_ECG
2131.jpg,432,288,N,1,285,610823,611108,MIT_BIH_ECG
2132.jpg,432,288,N,1,291,611108,611399,MIT_BIH_ECG
2133.jpg,432,288,N,1,296,611399,611695,MIT_BIH_ECG
2134.jpg,432,288,N,1,291,611695,611986,MIT_BIH_ECG
2135.jpg,432,288,N,1,277,611986,612263,MIT_BIH_ECG
2136.jpg,432,288,N,1,276,612263,612539,MIT_BIH_ECG
2137.jpg,432,288,N,1,280,612539,612819,MIT_BIH_ECG
2138.jpg,432,288,N,1,289,612819,613108,MIT_BIH_ECG
2139.jpg,432,288,N,1,291,613108,613399,MIT_BIH_ECG
2140.jpg,432,288,N,1,294,613399,613693,MIT_BIH_ECG
2141.jpg,432,288,N,1,290,613693,613983,MIT_BIH_ECG
2142.jpg,432,288,N,1,276,613983,614259,MIT_BIH_ECG
2143.jpg,432,288,N,1,280,614259,614539,MIT_BIH_ECG
2144.jpg,432,288,N,1,277,614539,614816,MIT_BIH_ECG
2145.jpg,432,288,N,1,273,614816,615089,MIT_BIH_ECG
2146.jpg,432,288,N,1,281,615089,615370,MIT_BIH_ECG
2147.jpg,432,288,N,1,306,615370,615676,MIT_BIH_ECG
2148.jpg,432,288,N,1,292,615676,615968,MIT_BIH_ECG
2149.jpg,432,288,N,1,282,615968,616250,MIT_BIH_ECG
2150.jpg,432,288,N,1,276,616250,616526,MIT_BIH_ECG
2151.jpg,432,288,N,1,277,616526,616803,MIT_BIH_ECG
2152.jpg,432,288,N,1,283,616803,617086,MIT_BIH_ECG
2153.jpg,432,288,N,1,280,617086,617366,MIT_BIH_ECG
2154.jpg,432,288,N,1,289,617366,617655,MIT_BIH_ECG
2155.jpg,432,288,N,1,294,617655,617949,MIT_BIH_ECG
2156.jpg,432,288,N,1,299,617949,618248,MIT_BIH_ECG
2157.jpg,432,288,N,1,280,618248,618528,MIT_BIH_ECG
2158.jpg,432,288,N,1,276,618528,618804,MIT_BIH_ECG
2159.jpg,432,288,N,1,277,618804,619081,MIT_BIH_ECG
2160.jpg,432,288,N,1,281,619081,619362,MIT_BIH_ECG
2161.jpg,432,288,N,1,291,619362,619653,MIT_BIH_ECG
2162.jpg,432,288,N,1,298,619653,619951,MIT_BIH_ECG
2163.jpg,432,288,N,1,298,619951,620249,MIT_BIH_ECG
2164.jpg,432,288,N,1,292,620249,620541,MIT_BIH_ECG
2165.jpg,432,288,N,1,285,620541,620826,MIT_BIH_ECG
2166.jpg,432,288,N,1,276,620826,621102,MIT_BIH_ECG
2167.jpg,432,288,N,1,277,621102,621379,MIT_BIH_ECG
2168.jpg,432,288,N,1,282,621379,621661,MIT_BIH_ECG
2169.jpg,432,288,N,1,283,621661,621944,MIT_BIH_ECG
2170.jpg,432,288,N,1,303,621944,622247,MIT_BIH_ECG
2171.jpg,432,288,N,1,294,622247,622541,MIT_BIH_ECG
2172.jpg,432,288,N,1,282,622541,622823,MIT_BIH_ECG
2173.jpg,432,288,N,1,266,622823,623089,MIT_BIH_ECG
2174.jpg,432,288,N,1,278,623089,623367,MIT_BIH_ECG
2175.jpg,432,288,N,1,271,623367,623638,MIT_BIH_ECG
2176.jpg,432,288,N,1,279,623638,623917,MIT_BIH_ECG
2177.jpg,432,288,N,1,274,623917,624191,MIT_BIH_ECG
2178.jpg,432,288,N,1,291,624191,624482,MIT_BIH_ECG
2179.jpg,432,288,N,1,283,624482,624765,MIT_BIH_ECG
2180.jpg,432,288,N,1,283,624765,625048,MIT_BIH_ECG
2181.jpg,432,288,N,1,261,625048,625309,MIT_BIH_ECG
2182.jpg,432,288,N,1,270,625309,625579,MIT_BIH_ECG
2183.jpg,432,288,N,1,274,625579,625853,MIT_BIH_ECG
2184.jpg,432,288,N,1,285,625853,626138,MIT_BIH_ECG
2185.jpg,432,288,N,1,289,626138,626427,MIT_BIH_ECG
2186.jpg,432,288,N,1,288,626427,626715,MIT_BIH_ECG
2187.jpg,432,288,N,1,285,626715,627000,MIT_BIH_ECG
2188.jpg,432,288,N,1,281,627000,627281,MIT_BIH_ECG
2189.jpg,432,288,N,1,274,627281,627555,MIT_BIH_ECG
2190.jpg,432,288,N,1,272,627555,627827,MIT_BIH_ECG
2191.jpg,432,288,N,1,276,627827,628103,MIT_BIH_ECG
2192.jpg,432,288,N,1,288,628103,628391,MIT_BIH_ECG
2193.jpg,432,288,N,1,297,628391,628688,MIT_BIH_ECG
2194.jpg,432,288,N,1,293,628688,628981,MIT_BIH_ECG
2195.jpg,432,288,N,1,190,628981,629171,MIT_BIH_ECG
2196.jpg,432,288,A_A,0,323,629171,629494,MIT_BIH_ECG
2197.jpg,432,288,N,1,267,629494,629761,MIT_BIH_ECG
2198.jpg,432,288,N,1,266,629761,630027,MIT_BIH_ECG
2199.jpg,432,288,N,1,262,630027,630289,MIT_BIH_ECG
2200.jpg,432,288,N,1,272,630289,630561,MIT_BIH_ECG
2201.jpg,432,288,N,1,275,630561,630836,MIT_BIH_ECG
2202.jpg,432,288,N,1,274,630836,631110,MIT_BIH_ECG
2203.jpg,432,288,N,1,267,631110,631377,MIT_BIH_ECG
2204.jpg,432,288,N,1,259,631377,631636,MIT_BIH_ECG
2205.jpg,432,288,N,1,262,631636,631898,MIT_BIH_ECG
2206.jpg,432,288,N,1,258,631898,632156,MIT_BIH_ECG
2207.jpg,432,288,N,1,258,632156,632414,MIT_BIH_ECG
2208.jpg,432,288,N,1,274,632414,632688,MIT_BIH_ECG
2209.jpg,432,288,N,1,270,632688,632958,MIT_BIH_ECG
2210.jpg,432,288,N,1,271,632958,633229,MIT_BIH_ECG
2211.jpg,432,288,N,1,269,633229,633498,MIT_BIH_ECG
2212.jpg,432,288,N,1,270,633498,633768,MIT_BIH_ECG
2213.jpg,432,288,N,1,260,633768,634028,MIT_BIH_ECG
2214.jpg,432,288,N,1,255,634028,634283,MIT_BIH_ECG
2215.jpg,432,288,N,1,262,634283,634545,MIT_BIH_ECG
2216.jpg,432,288,N,1,281,634545,634826,MIT_BIH_ECG
2217.jpg,432,288,N,1,281,634826,635107,MIT_BIH_ECG
2218.jpg,432,288,N,1,287,635107,635394,MIT_BIH_ECG
2219.jpg,432,288,N,1,290,635394,635684,MIT_BIH_ECG
2220.jpg,432,288,N,1,282,635684,635966,MIT_BIH_ECG
2221.jpg,432,288,N,1,272,635966,636238,MIT_BIH_ECG
2222.jpg,432,288,N,1,282,636238,636520,MIT_BIH_ECG
2223.jpg,432,288,N,1,291,636520,636811,MIT_BIH_ECG
2224.jpg,432,288,N,1,294,636811,637105,MIT_BIH_ECG
2225.jpg,432,288,N,1,294,637105,637399,MIT_BIH_ECG
2226.jpg,432,288,N,1,305,637399,637704,MIT_BIH_ECG
2227.jpg,432,288,N,1,293,637704,637997,MIT_BIH_ECG
2228.jpg,432,288,N,1,285,637997,638282,MIT_BIH_ECG
2229.jpg,432,288,N,1,278,638282,638560,MIT_BIH_ECG
2230.jpg,432,288,N,1,286,638560,638846,MIT_BIH_ECG
2231.jpg,432,288,N,1,294,638846,639140,MIT_BIH_ECG
2232.jpg,432,288,N,1,306,639140,639446,MIT_BIH_ECG
2233.jpg,432,288,N,1,298,639446,639744,MIT_BIH_ECG
2234.jpg,432,288,N,1,295,639744,640039,MIT_BIH_ECG
2235.jpg,432,288,N,1,290,640039,640329,MIT_BIH_ECG
2236.jpg,432,288,N,1,286,640329,640615,MIT_BIH_ECG
2237.jpg,432,288,N,1,285,640615,640900,MIT_BIH_ECG
2238.jpg,432,288,N,1,278,640900,641178,MIT_BIH_ECG
2239.jpg,432,288,N,1,301,641178,641479,MIT_BIH_ECG
2240.jpg,432,288,N,1,298,641479,641777,MIT_BIH_ECG
2241.jpg,432,288,N,1,288,641777,642065,MIT_BIH_ECG
2242.jpg,432,288,N,1,272,642065,642337,MIT_BIH_ECG
2243.jpg,432,288,N,1,277,642337,642614,MIT_BIH_ECG
2244.jpg,432,288,N,1,273,642614,642887,MIT_BIH_ECG
2245.jpg,432,288,N,1,277,642887,643164,MIT_BIH_ECG
2246.jpg,432,288,N,1,275,643164,643439,MIT_BIH_ECG
2247.jpg,432,288,N,1,282,643439,643721,MIT_BIH_ECG
2248.jpg,432,288,N,1,284,643721,644005,MIT_BIH_ECG
2249.jpg,432,288,N,1,281,644005,644286,MIT_BIH_ECG
2250.jpg,432,288,N,1,261,644286,644547,MIT_BIH_ECG
2251.jpg,432,288,N,1,260,644547,644807,MIT_BIH_ECG
2252.jpg,432,288,N,1,256,644807,645063,MIT_BIH_ECG
2253.jpg,432,288,N,1,257,645063,645320,MIT_BIH_ECG
2254.jpg,432,288,N,1,261,645320,645581,MIT_BIH_ECG
2255.jpg,432,288,N,1,282,645581,645863,MIT_BIH_ECG
2256.jpg,432,288,N,1,269,645863,646132,MIT_BIH_ECG
2257.jpg,432,288,N,1,261,646132,646393,MIT_BIH_ECG
2258.jpg,432,288,N,1,265,646393,646658,MIT_BIH_ECG
2259.jpg,432,288,N,1,258,646658,646916,MIT_BIH_ECG
2260.jpg,432,288,N,1,252,646916,647168,MIT_BIH_ECG
2261.jpg,432,288,N,1,246,647168,647414,MIT_BIH_ECG
2262.jpg,432,288,N,1,258,647414,647672,MIT_BIH_ECG
2263.jpg,432,288,N,1,262,647672,647934,MIT_BIH_ECG
2264.jpg,432,288,N,1,269,647934,648203,MIT_BIH_ECG
2265.jpg,432,288,N,1,274,648203,648477,MIT_BIH_ECG
2266.jpg,432,288,N,1,256,648477,648733,MIT_BIH_ECG
2267.jpg,432,288,N,1,245,648733,648978,MIT_BIH_ECG
2268.jpg,432,288,N,1,254,648978,649232,MIT_BIH_ECG
2269.jpg,432,288,N,1,252,649232,649484,MIT_BIH_ECG
2270.jpg,432,288,N,1,250,649484,649734,MIT_BIH_ECG
2271.jpg,432,288,N,1,257,649734,649991,MIT_BIH_ECG
